abandon	abandoned	abandoned	abandoning
abase	abased	abased	abasing
abash	abashed	abashed	abashing
abate	abated	abated	abating
abbreviate	abbreviated	abbrivated	abbreviating
abdicate	abdicated	abdicated	abdicating
abduct	abducted	abducted	abducting
abet	abetted	abetted	abetting
abhor	abhorred	abhorred	abhorring
abide	abided	abided	abiding
abjure	abjured	abjured	abjuring
abnegate	abnegated	abnegated	abnegating
abolish	abolished	abolished	abolishing
abominate	abominated	abominated	abominating
abound	abounded	abounded	abounding
abridge	abridged	abridged	abridging
abrogate	abrogated	abrogated	abrogating
abscond	absconded	absconded	absconding
absent	absented	absented	absenting
absolve	absolved	absolved	absolving
absorb	absorbed	absorbed	absorbing
abstain	abstained	abstained	abstraining
abuse	abused	abused	abusing
abuse	abused	abused	abusing
abut	abutted	abutted	abutting
accede	acceded	acceded	acceding
accelerate	accelerated	accelerated	accelerating
accentuate	accentuated	accentuated	accentuating
accept	accepted	accepted	accepting
acclaim	acclaimed	acclaimed	acclaiming
acclimatize	acclimatized	acclimatized	acclimatizing
accommodate	accommodated	accommodated	accommodating
accompany	accompanied	accompanied	accompanying
accomplish	accomplished	accomplished	accomplishing
accord	accorded	accorded	according
accost	accosted	accosted	accosting
account	accounted	accounted	accounting
accredit	accredited	accredited	accrediting
accumulate	accumulated	accumulated	accumulating
accuse	accused	accused	accusing
accustom	accustomed	accustomed	accustoming
acerbate	acerbateed	acerbateed	acerbateing
ache	ached	ached	aching
ache	ached	ached	aching
achieve	achieved	achieved	achieving
achieve	achieved	achieved	achieving
acknowledge	acknowledged	acknowledged	acknowledging
acquaint	acquainted	acquainted	acquainting
acquiesce	acquiesced	acquiesced	acquiescing
acquire	acquired	acquired	acquiring
acquit	acquitted	acquitted	acquitting
act	acted	acted	acting
activate	activated	activated	activating
actualize	actualized	actualized	actualizing
actuate	actuated	actuated	actuating
adapt	adapted	adapted	adapting
add	added	added	adding
addict	addicted	addicted	addicting
address	addressed	addressed	addressing
adduce	adduced	adduced	adducing
adhere	adhered	adhered	adhering
adjudge	adjudged	adjudged	adjudging
adjure	adjured	adjured	adjuring
adjust	adjusted	adjusted	adjusting
administer	administered	administered	administering
admire	admired	admired	admiring
admit	admitted	admitted	admitting
admonish	admonished	admonished	admonishing
adom	adorned	adorned	adorning
adopt	adopted	adopted	adopting
adore	adored	adored	adoring
adorn	adorned	adorned	adorning
adulterate	adulterated	adulterated	adulterating
advance	advanced	advanced	advancing
advantage	advantaged	advantaged	advantaging
adventure	adventured	adventured	adventuring
advert	adverted	adverted	adverting
advertise	advertised	advertised	advertising
advice	adviced	adviced	advicing
advise	advised	advised	advising
advocate	advocated	advocated	advocating
aerate	aerated	aerated	aerating
affect	affected	affected	affecting
affirm	affirmed	affirmed	affirming
affix	affixed	affixed	affixing
afflict	afflicted	afflicted	afflicting
afford	afforded	afforded	affording
afforest	afforested	afforested	afforesting
affront	affronted	affronted	affronting
age	aged	aged	ageing
agglomerate	agglomerated	agglomerated	agglomerating
agglutinate	agglutinated	agglutinated	agglutinating
aggrandize	aggrandized	aggrandized	aggrandizing
aggravate	aggravated	aggravated	aggravating
aggregate	aggregated	aggregated	aggregating
aggrieve	aggrieved	aggrieved	aggrieving
agitate	agitated	agitated	agitating
agonize	agonized	agonized	agonizing
agree	agreed	agreed	agreeing
aid	aided	aided	aiding
ail	ailed	ailed	ailing
ail	aimed	aimed	aiming
aim	aired	aired	airing
aim	alighted	alighted	alighting
air	allayed	allayed	allaying
air	alleged	alleged	alleging
alight	alleviated	alleviated	alleviating
alight	alliterated	alliterated	alliterating
allay	allocated	allocated	allocating
allay	allotted	allotted	allotting
allege	allowed	allowed	allowing
allege	alluded	alluded	alluding
alleviate	allured	allured	alluring
alleviate	allied	allied	allying
alliterate	altered	altered	altering
alliterate	altercated	altercated	altercating
allocate	amalgamated	amalgamated	amalgamating
allocate	amassed	amassed	amassing
allot	amazed	amazed	amazing
allot	ambled	ambled	ambling
allow	ambulated	ambulated	ambulating
allow	amended	amended	amending
allude	amplified	amplified	amplifying
allude	amused	amused	amusing
allure	analysed	analysed	analysing
allure	ailed	ailed	ailing
ally	aimed	aimed	aiming
ally	aired	aired	airing
alter	alighted	alighted	alighting
alter	allayed	allayed	allaying
altercate	alleged	alleged	alleging
altercate	alleviated	alleviated	alleviating
amalgamate	alliterated	alliterated	alliterating
amalgamate	allocated	allocated	allocating
amass	allotted	allotted	allotting
amass	allowed	allowed	allowing
amaze	alluded	alluded	alluding
amaze	allured	allured	alluring
amble	allied	allied	allying
amble	altered	altered	altering
ambulate	altercated	altercated	altercating
ambulate	amalgamated	amalgamated	amalgamating
amend	amassed	amassed	amassing
amend	amazed	amazed	amazing
amplify	ambled	ambled	ambling
amplify	ambulated	ambulated	ambulating
amuse	amended	amended	amending
amuse	amplified	amplified	amplifying
analyse	amused	amused	amusing
analyse	analysed	analysed	analysing
anger	angered	angered	angering
angle	angled	angled	angling
anglicise	anglicised	anglicised	anglicising
animate	animated	animated	animating
annex	annexed	annexed	annexing
annihilate	annihilated	annihilated	annihilating
annotate	annotated	annotated	annotating
announce	announced	announced	announcing
annoy	annoyed	annoyed	annoying
annul	annulled	annulled	annulling
annul	annulled	annulled	annulling
answer	answered	answered	answering
antagonize	antagonized	antagonized	antagonizing
antecede	anteceded	anteceded	anteceding
antedate	antedated	antedated	antedating
anticipate	anticipated	anticipated	anticipating
apologize	apologized	apologized	apologizing
appal	appalled	appalled	appalling
appeal	appealed	appealed	appealing
appear	appeared	appeared	appearing
appease	appeased	appeased	appeasing
applaud	applauded	applauded	applauding
apply	applied	applied	applying
appoint	appointed	appointed	appointing
appreciate	appreciated	appreciated	appreciating
apprehend	apprehended	apprehended	apprehending
approach	approached	approached	approaching
approve	approved	approved	approving
arbitrate	arbitrated	arbitrated	arbitrating
arch	arched	arched	arching
argue	argued	argued	arguing
arise	arose	arisen	arising
arm	armed	armed	armimg
arm	armed	armed	rming
arouse	aroused	aroused	arousing
arrange	arranged	arranged	arranging
array	arrayed	arrayed	arraying
arrest	arrested	arrested	arresting
arrive	arrived	arrived	arriving
ascend	ascended	ascended	ascending
ascertain	ascertained	ascertained	ascertaining
ask	asked	asked	asking
aspire	aspired	aspired	aspiring
assail	assailed	assailed	assailing
assassinate	assassinated	assassinated	assassinating
assemble	assembled	assembled	assembling
assert	asserted	asserted	asserting
assess	assessed	assessed	assessing
assign	assigned	assigned	assigning
assist	assisted	assisted	assisting
associate	associated	associated	associating
assort	assorted	assorted	assorting
assume	assumed	assumed	assuming
assure	assured	assured	assuring
astonish	astonished	astonished	astonishing
astound	astounded	astounded	astounding
attach	attached	attached	attaching
attack	attacked	attacked	attacking
attain	attained	attained	attaining
attempt	attempted	attempted	attempting
attend	attended	attended	attending
attest	attested	attested	attesting
attract	attracted	attracted	attracting
attribute	attributed	attributed	attributing
attune	attuned	attuned	attuning
audit	audited	audited	auditing
augment	augmented	augmented	augmenting
authorize	authorized	authorized	authorizing
avail	availed	availed	availing
avenge	avenged	avenged	avenging
aver	averred	averred	averring
avert	averted	averted	averting
avoid	avoided	avoided	avoiding
avouch	avouched	avouched	avouching
avow	avowed	avowed	avowing
await	awaited	awaited	awaiting
awake	awoke	awoken	awaking
awaken	awakened	awakened	awakening
award	awarded	awarded	awarding
back	backed	backed	backing
back stab	back stabbed	back stabbed	back stabbing
backslide	backslided	backslided	backsliding
baffle	baffled	baffled	baffling
baffle	baffled	baffled	baffling
bag	bagged	bagged	bagging
bait	baited	baited	baiting
baize	baized	baized	baizing
bake	baked	baked	baking
bake	baked	baked	baking
balance	balanced	balanced	balancing
balk	balked	balked	balking
bamboozle	bamboozled	bamboozled	bamboozling
ban	banned	banned	banning
bandage	bandaged	bandaged	bandaging
bandage	bandaged	bandaged	bandaging
bandy	bandied	bandied	bandying
bang	banged	banged	banging
banish	banished	banished	banishing
bank	banked	banked	banking
banter	bantered	bantered	bantering
baptize	baptized	baptized	baptizing
baptize	baptized	baptized	baptizing
bar	barred	barred	barring
bare	bared	bared	baring
bare	bared	bared	baring
bargain	bargained	bargained	bargaining
barge	barged	barged	barging
bark	barked	barked	barking
barter	bartered	bartered	bartering
base	based	based	basing
base	based	based	basing
bash	bashed	bashed	bashing
bask	basked	basked	basking
bastardize	bastardized	bastardized	bastardizing
bat	batted	batted	batting
bate	bated	bated	bating
bathe	bathed	bathed	bathing
batten	battened	battened	battening
batter	battered	battered	battering
battle	battled	battled	battling
bawl	bawled	bawled	bawling
beam	beamed	beamed	beaming
bear	bore	borne	bearing
beat	beat	beaten	beating
becalm	becalmed	becalmed	becalming
beck	becked	becked	becking
beckon	beckoned	beckoned	beckoning
becloud	beclouded	beclouded	beclouding
become	became	became	becoming
bedaub	bedaubed	bedaubed	bedaubing
bedazzle	bedazzled	bedazzled	bedazzling
bedeck	bedecked	bedecked	bedecking
bedevil	bedeviled	bedeviled	bedeviling
bedew	bedewed	bedewed	bedewing
bedizen	bedizened	bedizened	bedizening
bedraggle	bedraggled	bedraggled	bedraggling
beetle	beetled	beetled	beetling
befall	befell	befallen	befalling
befit	befitted	befitted	befitting
befog	befogged	befogged	befogging
befoul	befouled	befouled	befouling
befriend	befriended	befriended	befriending
beg	begged	begged	begging
beget	begot	begotted	begetting
begin	began	begun	beginning
begrudge	begrudged	begrudged	begrudging
beguile	beguiled	beguiled	beguiling
behave	behaved	behaved	behaving
behead	beheaded	beheaded	beheading
behold	beheld	beheld	beholding
belabour	belaboured	belaboured	belabouring
belay	belayed	belayed	belaying
belch	belched	belched	belching
beleaguer	beleaguered	beleaguered	beleaguering
believe	believed	believed	believing
belittle	belittled	belittled	belittling
bellow	bellowed	bellowed	bellowing
belong	belonged	belonged	belonging
bemoan	bemoaned	bemoaned	bemoaning
bend	bent	bent	bending
benefit	benefited	benefited	benefiting
benumb	benumbed	benumbed	benumbing
bequeath	bequeathed	bequeathed	bequeathing
berate	berated	berated	berating
bereave	bereaved	bereaved	bereaving
beseech	besought	besought	beseeching
beseem	beseemed	beseemed	beseeming
beset	beset	beset	besetting
besiege	besieged	besieged	besieging
besmear	besmeared	besmeared	besmearing
bespangle	bespangled	bespangled	bespangling
bespeak	bespoke	bespoken	bespeaking
bestow	bestowed	bestowed	bestowing
bestride	bestrode	bestrode	bestriding
bet	betted	betted	betting
betake	betook	betaken	betaking
bethink	bethought	bethought	bethinking
betide	betided	betided	betiding
betoken	betokened	betokened	betokening
betray	betrayed	betrayed	betraying
betroth	betrothed	betrothed	betrothing
bewail	bewailed	bewailed	bewailing
beware	bewared	bewared	bewaring
bewilder	bewildered	bewildered	bewildering
bewitch	bewitched	bewitched	bewitching
bicker	bickered	bickered	bickering
bid	bade	bidden	bidding
bide	bided	bided	biding
bifurcate	bifurcated	bifurcated	bifurcating
bike	biked	biked	biking
bilk	bilked	bilked	bilking
bill	billed	billed	billing
bind	bound	bound	binding
bisect	bisected	bisected	biseting
bite	bit	bitten	biting
blab	blabbed	blabbed	blabbing
blacken	blackened	blackened	blackening
blame	blamed	blamed	blaming
blame	blamed	blamed	blaming
blanch	blanched	blanched	blanching
blandish	blandished	blandished	blandishing
blare	blared	blared	blaring
blare	blared	blared	blaring
blast	blasted	blasted	blasting
blaze	blazed	blazed	blazing
bleach	bleached	bleached	bleaching
bleat	bleated	bleated	bleating
bleed	bled	bled	bleeding
blemish	blemished	blemished	blemishing
blench	blenched	blenched	blenching
blend	blended	blended	blending
bless	blessed	blessed	blessing
blether	blethered	blethered	blethering
blight	blighted	blighted	blighting
blind	blinded	blinded	blinding
blind fold	blind folded	blind folded	blind folding
blindfold	blindfolded	blindfolded	blindfolding
blink	blinked	blinked	blinking
blither	blithered	blithered	blithering
bloat	bloated	bloated	bloating
block	blocked	blocked	blocking
blockade	blockaded	blockaded	blockading
bloom	bloomed	bloomed	blooming
blossom	blossomed	blossomed	blossoming
blot	blotted	blotted	blotting
blow	blew	blown	blowing
blunder	blundered	blundered	blundering
blur	blurred	blurred	blurring
blurt	blurted	blurted	blurting
blush	blushed	blushed	blushing
board	boarded	boarded	boarding
boast	boasted	boasted	boasting
bode	boded	boded	boding
boggle	boggled	boggled	boggling
boil	boiled	boiled	boiling
bolt	bolted	bolted	bolting
bomb	bombed	bombed	bombing
bone	boned	boned	boning
boo	booed	booed	booing
book	booked	booked	booking
boom	boomed	boomed	booming
boost	boosted	boosted	boosting
boot	booted	booted	booting
bootlick	bootlicked	bootlicked	bootlicking
booze	boozed	boozed	boozing
border	bordered	bordered	bordering
bore	bored	bored	boring
borrow	borrowed	borrowed	borrowing
bother	bothered	bothered	bothering
bottle	bottled	bottled	bottling
bottle neck	bottle necked	bottle necked	bottle necking
bounce	bounced	bounced	bouncing
bound	bounded	bounded	bounding
bow	bowed	bowed	bowing
bowl	bowled	bowled	bowling
box	boxed	boxed	boxing
boycott	boycotted	boycotted	boycotting
brace	braced	braced	bracing
brag	bragged	bragged	bragging
braid	braided	braided	braiding
brake	braked	braked	braking
branch	branched	branched	branching
brand	branded	branded	branding
brandish	brandished	brandished	brandishing
brawl	brawled	brawled	brawling
bray	brayed	brayed	braying
break	broke	broken	breaking
breathe	breathed	breathed	breathing
breed	bred	bred	breeding
brew	brewed	brewed	brewing
bribe	bribed	bribed	bribing
bridle	bridled	bridled	bridling
brighten	brightened	brightened	brightening
brim	brimmed	brimmed	brimming
bring	brought	brought	bringing
bristle	bristled	bristled	bristling
broach	broached	broached	broaching
broad cast	broad casted	broad casted	broad casting
broadcast	broadcast	broadcast	broadcating
brocade	brocaded	brocaded	brocading
broil	broiled	broiled	broiling
brood	brooded	brooded	brooding
brook	brooked	brooked	brooking
brow beat	browbeat	browbeaten	browbeating
brown	browned	browned	browning
browse	browsed	browsed	browsing
bruise	bruised	bruised	bruising
bruit	bruited	bruited	bruiting
brush	brushed	brushed	brushing
brutalize	brutalized	brutalized	brutalizing
buck	bucked	bucked	bucking
buckle	buckled	buckled	buckling
budge	budged	budged	budging
buffet	buffeted	buffeted	buffeting
build	built	built	building
bulge	bulged	bulged	bulging
bully	bullied	bullied	bullying
bullyrag	bullyragged	bullyragged	bullyragging
bumble	bumbled	bumbled	bumbling
bump	bumped	bumped	bumping
bundle	bundled	bundled	bundling
bungle	bungled	bungled	bungling
buoy	buoyed	buoyed	buoying
burden	burdened	burdened	burdening
burgle	burgled	burgled	burgling
burn	burned / burnt	burned / burnt	burning
burnish	burnished	burnished	burnishing
burrow	burrowed	burrowed	burrowing
burst	burst	burst	bursting
bury	buried	buried	burying
bust	busted	busted	busting
bustle	bustled	bustled	bustling
butch	butched	butched	butching
button	buttoned	buttoned	buttoning
buy	bought	bought	buying
buzz	buzzed	buzzed	buzzing
cachinnate	cachinnated	cachinnated	cachinnating
cacle	cackled	cackled	cackling
cadge	cadged	cadged	cadging
cage	caged	caged	caging
cage	caged	caged	caging
cajole	cajoled	cajoled	cajoling
cake	caked	caked	caking
calcify	calcified	calcified	calcifying
calculate	calculated	calculated	calculating
calibrate	calibrated	calibrated	calibrating
call	called	called	calling
calve	calved	calved	calving
camouflage	camouflaged	camouflaged	camouflaging
camp	camped	camped	camping
cancel	cancelled	cancelled	cancelling
canonize	canonized	canonized	canonizing
canvass	canvassed	canvassed	canvassing
cap	capped	capped	capping
capacitate	capacitated	capacitated	capacitating
caper	capered	capered	capering
capitalize	capitalized	capitalized	capitalizing
capitulate	capitulated	capitulated	capitulating
capsize	capsized	capsized	capsizing
captivate	captivated	captivated	captivating
capture	captured	captured	capturing
care	cared	cared	caring
careen	careened	careened	careening
carouse	caroused	caroused	carousing
carry	carried	carried	carrying
carve	carved	carved	carving
cash	cashed	cashed	cashing
cast	cast	cast	casting
castigate	castigated	castigated	castigating
castrate	castrated	castrated	castrating
catapult	catapulted	catapulted	catapulting
catch	caught	caught	catching
catechize	catechized	catechized	catechizing
categorize	categorized	categorized	categorizing
cater	catered	catered	catering
caulk	caulked	caulked	caulking
cause	caused	caused	causing
cauterize	cauterized	cauterized	cauterizing
caution	cautioned	cautioned	cautioning
caw	cawed	cawed	cawing
cease	ceased	ceased	ceasing
cede	ceded	ceded	ceding
celebrate	celebrated	celebrated	celebrating
cement	cemented	cemented	cementing
censor	censored	censored	censoring
censure	censured	censured	censuring
centralize	centralized	centralized	centralizing
centre	centred	centred	centring
centuple	centupled	centupled	centupling
certify	certified	certified	certifying
chaffer	chaffered	chaffered	chaffering
chagrin	chagrined	chagrined	chagrining
chain	chained	chained	chaining
chalk	chalked	chalked	chalking
challenge	challenged	challenged	challenging
challenged	challenged	challenged	challenging
champion	championed	championed	championing
chance	chanced	chanced	chancing
change	changed	changed	changing
channel	channelled	channelled	chanelling
chant	chanted	chanted	chanting
chap	chapped	chapped	chapping
char	charred	charred	charring
charge	charged	charged	charging
charm	charmed	charmed	charming
chase	chased	chased	chasing
chasten	chastened	chastened	chastening
chastise	chastised	chastised	chastising
chat	chatted	chatted	chatting
chatter	chattered	chattered	chatering
cheapen	cheapened	cheapened	cheapening
cheat	cheated	cheated	cheating
check	checked	checked	checaking
cheer	cheered	cheered	cheering
cherish	cherished	cherished	cherishing
chew	chewed	chewed	chewing
chide	chid	chidden / chided	chiding
chink	chinked	chinked	chinking
chip	chipped	chipped	chipping
chlorine	chlorined	chlorined	chlorining
choke	choked	choked	choking
choose	chose	chosen	choosing
chop	chopped	chopped	chopping
chortle	chortled	chortled	chortling
christen	christened	christened	christening
chuck	chucked	chucked	chucking
chuckle	chuckled	chuckled	chuckling
circle	circled	circled	circling
circulate	circulated	circulated	circulating
circumambulate	circumambulated	circumambulated	circumambulating
circumscribe	circumscribed	circumscribed	circumscribing
circumvent	circumvented	circumvented	circumventing
civilize	civilized	civilized	civilizing
claim	claimed	claimed	claiming
clamour	clamoured	clamoured	clamouring
clang	clanged	clanged	clanging
clank	clanked	clanked	clanking
clap	clapped	clapped	clapping
clarify	clarified	clarified	clarifying
clash	clashed	clashed	clashing
clasp	clasped	clasped	clasping
classify	classified	classified	classifying
clatter	clattered	clattered	clattering
clean	cleaned	cleaned	cleaning
clear	cleared	cleared	clearing
cleave	cleft / clove	cleft / cloven	cleaving
clench	clenched	clenched	clenching
click	clicked	clicked	clicking
climb	climbed	climbed	climbing
cling	clung	clung	clinging
clip	clipped	clipped	clipping
clog	clogged	clogged	clogging
close	closed	closed	closing
clot	clotted	clotted	clotting
clothe	clothed	clothed	clothing
cloy	cloyed	cloyed	cloying
cluck	clucked	clucked	clucking
clutch	clutched	clutched	clutching
co ordinate	co ordinates	co ordinated	co ordinating
coach	coached	coached	coaching
coalesce	coalesced	coalesced	coalescing
coast	coasted	coasted	coasting
coat	coated	coated	coating
coax	coaxed	coaxed	coaxing
cobble	cobbled	cobbled	cobbling
coddle	coddled	coddled	coddling
codify	codified	codified	codifying
coerce	coerced	coerced	coercing
coexist	coexisted	coexisted	coexisting
cogitate	cogitated	cogitated	cogitating
cohere	cohered	cohered	cohering
coil	coiled	coiled	coiling
coin	coined	coined	coining
coincide	coincided	coincided	coinciding
collaborate	collaborated	collaborated	collaborating
collapse	collapsed	collapsed	collapsing
collate	collated	collated	collating
collect	collected	collected	collecting
collide	collided	collided	colliding
collide	collided	collided	colliding
collocate	collocated	collocated	collocating
collude	colluded	colluded	colluding
colonize	colonized	colonized	colonizing
colour	coloured	coloured	colouring
comb	combed	combed	combing
combat	combated	combated	combating
combine	combined	combined	combining
come	came	come	coming
comfort	comforted	comforted	comforting
command	commanded	commanded	commanding
commandeer	commandeered	commandeered	commandeering
commemorate	commemorated	commemorated	commemorating
commence	commenced	commenced	commencing
commend	commended	commended	commending
comment	comented	commented	commenting
commentate	commentated	commentated	commentating
commingle	commingled	commingled	commingling
commiserate	commiserated	commiserated	commiserating
commit	committed	committed	committing
commune	communed	communed	communing
communicate	communicated	communicated	communicating
commutate	commutated	commutated	commutating
commute	commuted	commuted	commuting
compare	compared	compared	comparing
compel	compelled	compelled	compelling
compensate	compensated	compensated	compensating
compete	competed	competed	competing
compile	compiled	compiled	compiling
complain	complained	complained	complaining
complement	complemented	complemented	complementing
complete	completed	completed	completing
complicate	complicated	complicated	complicating
compliment	complimented	complimented	complimenting
complot	comploted	comploted	comploting
comply	complied	complied	complying
comport	comported	comported	comporting
compose	composed	composed	composing
compound	compounded	compounded	compounding
comprehend	comprehended	comprehended	comprehending
compress	compressed	compressed	compressing
comprise	comprised	comprised	comprising
compromise	compromised	compromised	compromising
compute	computed	computed	computing
computerize	computerized	computerized	computerizing
conceal	concealed	concealed	concealing
concede	conceded	conceded	conceding
conceive	conceived	conceived	conceiving
conceive	conceived	conceived	conceiving
concentrate	concentrated	concentrated	concentrating
concern	concerned	concerned	concerning
concert	concerted	concerted	concerting
conciliate	conciliated	conciliated	conciliating
conclude	concluded	concluded	concluding
concrete	concreted	concreted	concreting
concur	concurred	concurred	concurring
condemn	condemned	condemned	condemning
condense	condensed	condensed	condensing
condescend	condescended	condescended	condescending
condition	conditioned	conditioned	conditioning
condole	condoled	condoled	condoling
condone	condoned	condoned	condoning
conduct	conducted	conducted	conducting
confabulate	confabulated	confabulated	confabulating
confabulate	confabulated	confabulated	confabulating
confect	confected	confected	confecting
confer	conferred	conferred	conferring
confess	confessed	confessed	confessing
confide	confideed	confideed	confideing
configure	configured	configured	configuring
confine	confined	confined	confining
confirm	confirmed	confirmed	confirming
confiscate	confiscated	confiscated	confiscating
conflate	conflated	conflates	conflating
conflict	conflicted	conflicted	conflicting
conform	conformed	conformed	conforming
confound	confounded	confounded	confounding
confront	confronted	confronted	confronting
confuse	confused	confused	confusing
confute	confuted	confuted	confuting
congeal	congealed	congealed	congealing
congest	congested	congested	congesting
conglomerate	conglomerated	conglomerated	conglomerating
congratulate	congratulated	congratulated	congratulating
congratulated	congratulated	congratulated	congratulating
congregate	congregated	congregated	congregating
conjecture	conjectured	conjectured	conjecturing
conjoin	conjoined	conjoined	conjoining
conjugate	conjugated	conjugated	conjugating
conjure	conjureed	conjureed	conjureing
conk	conked	conked	conking
connect	connected	connected	connecting
connive	connived	connived	conniving
connote	connoted	connoted	connoting
conquer	conquered	conquered	conquering
conqure	conquered	conquered	conquering
conscript	conscripted	conscripted	conscripting
consecrate	consecrated	consecrated	consecrating
consent	consented	consented	consenting
conserve	conserved	conserved	conserving
consider	considered	considered	considering
consign	consigned	consigned	consigning
consist	consisted	consisted	consisting
console	consoled	consoled	consoling
consolidate	consolidated	consolidated	consolidating
consort	consorted	consorted	consorting
conspire	conspired	conspired	conspiring
constitute	constituted	constituted	constituting
constrain	constrained	constrained	constraining
constrict	constricted	constricted	constricting
construct	constructed	constructed	constructing
construe	construed	construed	construing
consult	consulted	consulted	consulting
consume	consumeed	consumeed	consumeing
consummate	consummated	consummated	consummating
contact	contacted	contacted	contacting
contain	contained	contained	containing
contaminate	contaminated	contaminated	contaminating
contemplate	contemplated	contemplated	contemplating
contend	contended	contended	contending
content	contented	contented	contenting
contest	contested	contested	contesting
contian	contained	contained	containing
continue	continued	continued	continuing
contort	contorted	contorted	contorting
contract	contracted	contracted	contracting
contradict	contradicted	contradicted	contradicting
contrast	contrasted	contrasted	contrasting
contravene	contravened	contravened	contravening
contribute	contributed	contributed	contributing
contrive	contrived	contrived	contriving
control	controlled	controlled	controlling
controvert	controverted	controverted	controverting
convalesce	convalesced	convalesced	convalescing
convene	convened	convened	convening
converge	converged	converged	converging
converse	conversed	conversed	conversing
convert	converted	converted	converting
convey	conveyed	conveyed	conveying
convict	convicted	convicted	convicting
convince	convinced	convinced	convincing
convoke	convoked	convoked	convoking
convoy	convoyed	convoyed	convoying
convulse	convulsed	convulsed	convulsing
coo	coos	cooed	cooing
cook	cooked	cooked	cooking
cool	cooled	cooled	cooling
co-operate	coped	coped	coping
co-operate	copulated	copulated	copulating
co-ordinate	copied	copied	copying
cope	cordoned	cordoned	cordoning
copulate	corned	corned	corning
corn	cornered	cornered	cornering
corner	corrected	corrected	correcting
correlate	correlated	correlated	correlating
correspond	corresponded	corresponded	corresponding
corroborate	corroborated	corroborated	corroborating
corrode	corroded	corroded	corroding
corrupt	corrupted	corrupted	corrupting
coruscate	coruscated	coruscated	coruscating
cost	cost	cost	costing
couch	couched	couched	couching
cough	coughed	coughed	coughing
counsel	counselled	counselled	counselling
count	counted	counted	counting
countenance	countenanced	countenanced	countenancing
counter	countered	countered	countering
counteract	counteracted	counteracted	counteracting
counterargue	counterargued	counterargued	counterarguing
countersign	countersigned	countersigned	countersigning
couple	coupleed	coupleed	coupleing
course	coursed	coursed	coursing
cover	covered	covered	covering
covet	coveted	coveted	coveting
cower	cowered	cowered	cowering
crack	cracked	cracked	cracking
crackle	crackled	crackled	crackling
cradle	cradled	cradled	cradling
cramp	cramped	cramped	cramping
crane	craned	craned	craning
crash	crashed	crashed	crashing
crave	craved	craved	craving
crawl	crawled	crawled	crawling
craze	crazed	crazed	crazing
crease	creased	creased	creasing
create	created	created	creating
credit	credited	credited	creaditing
creep	crept	crept	creeping
cremate	cremated	cremated	cremating
criminate	criminated	criminated	criminating
crimple	crimpled	crimpled	crimpling
cringe	cringed	cringed	cringing
crinkle	crinkled	crinkled	crinkling
cripple	crippled	crippled	crippling
criticize	criticized	criticized	criticizing
crop	cropped	cropped	cropping
cross	crossed	crossed	crossing
crouch	crouched	crouched	crouching
crow	crowed	crowed	crowing
crowd	crowded	crowded	crowding
crown	crowned	crowned	crowning
crucify	crucified	crucified	crucifying
cruise	cruised	cruised	cruising
crumble	crumbled	crumbled	crumbling
crump	crumped	crumped	crumping
crunch	crunched	crunched	crunching
crush	crushed	crushed	crushing
cry	cried	cried	crying
cuddle	cuddled	cuddled	cuddling
cuff	cuffed	cuffed	cuffing
cull	culled	culled	culling
culminate	culminated	culminated	culminating
cultivate	cultivated	cultivated	cultivating
culture	cultured	cultured	culturing
cumber	cumbered	cumbered	cumbering
curb	curbed	curbed	curbing
curdle	curdled	curdled	curdling
cure	cured	cured	curing
curl	curled	curled	curling
curr	curred	curred	curring
curse	cursed	cursed	cursing
curtail	curtailed	curtailed	curtailing
curve	curved	curved	curving
cushion	cushioned	cushioned	cushioning
cut	cut	cut	cutting
cycle	cycled	cycled	cycling
cypher	cyphered	cyphered	cyphering
dab	dabbed	dabbed	dabbing
dabble	dabbled	dabbled	dabbling
dally	dallied	dallied	dallying
dam	dams	dammed	damming
damage	damaged	damaged	damaging
damange	damaged	damaged	damaging
damn	damned	damned	damning
dance	danced	danced	dancing
dandle	dandles	dandled	dandling
dangle	dangled	dangled	dangling
dap	dapped	dapped	dapping
dapple	dappled	dappled	dappling
dare	dared	dared	daring
darken	darkened	darkened	darkening
darn	darned	darned	darning
dart	darted	darted	darting
dash	dashed	dashed	dashing
date	dated	dated	dating
daub	daubed	daubed	daubing
daunt	daunted	daunted	daunting
dawdle	dawdled	dawdled	dawdling
dawn	dawned	dawned	dawning
dazzle	dazzled	dazzled	dazzling
deactivate	deactivates	deactivated	deactivating
deactivate	deactivates	deactivated	deactivating
deaden	deadened	deadened	deadening
deafen	deafened	deafened	deafening
deal	dealt	dealt	dealing
debar	debarred	debarred	debarring
debark	debarked	debarked	debarking
debase	debased	debased	debasing
debate	debated	debated	debating
debauch	debauched	debauched	debauching
debilitate	debilitated	debilitated	debilitating
debit	debited	debited	debiting
debunk	debunked	debunked	debunking
decant	decanted	decanted	decanting
decapitate	decapitated	decapitated	decapitating
decarbonize	decarbonized	decarbonized	decarbonizing
decay	decayed	decayed	decaying
deceive	deceived	deceived	deceiving
decelerate	decelerated	decelerated	decelerating
decentralize	decentralized	decentralized	decentralizing
decide	decided	decided	deciding
decimate	decimated	decimated	decimating
decipher	deciphered	deciphered	deciphering
deck	decked	decked	decking
declaim	declaimed	declaimed	declaiming
declare	declared	declared	declaring
decline	declined	declined	declining
decode	decoded	decoded	decoding
decompose	decomposed	decomposed	decomposing
decontaminate	decontaminated	decontaminated	decontaminating
decontrol	decontrolled	decontrolled	decontrolling
decorate	decorated	decorated	decorating
decrease	decreased	decreased	decreasing
decry	decried	decried	decrying
dedicate	dedicated	dedicated	dedicating
deduce	deduced	deduced	deducing
deduct	deducted	deducted	deducting
deem	deemed	deemed	deeming
deep	deeped	deeped	deeping
deepen	deepened	deepened	deepening
deface	defaced	defaced	defacing
defalcate	defalcated	defalcated	defalcating
defame	defamed	defamed	defaming
default	defaulted	defaulted	defaulting
defeat	defeated	defeated	defeating
defecate	defecated	defecated	defecating
defend	defended	defended	defending
defer	deferred	deferred	deferring
defile	defiled	defiled	defiling
define	defined	defined	defining
deflect	deflected	deflected	deflecting
deform	deformed	deformed	deforming
defraud	defrauded	defrauded	defrauding
defray	defrayed	defrayed	defraying
defrost	defrosted	defrosted	defrosting
defy	defied	defied	defying
degrade	degraded	degraded	degrading
deify	deified	deified	deifying
deject	dejected	dejected	dejecting
delay	delayed	delayed	delaying
delete	deleted	deleted	deleting
delight	delighted	delighted	delighting
deliver	delivered	delivered	delivering
delude	deluded	deluded	deluding
delve	delved	delved	delving
demand	demanded	demanded	demanding
demarcate	demarcated	demarcated	demarcating
demean	demeaned	demeaned	demeaning
dement	demented	demented	dementing
demit	demitted	demitted	demitting
demolish	demolished	demolished	demolishing
demonetize	demonetized	demonetized	demonetizing
demonstrate	demonstrated	demonstrated	demonstrating
demoralize	demoralized	demoralized	demoralizing
demur	demurred	demurred	demurring
denote	denoted	denoted	denoting
denunciate	denunciated	denunciated	denunciating
deny	denied	denied	denying
depart	departed	departed	departing
depend	depended	depended	depending
depict	depicted	depicted	depicting
deplete	depleted	depleted	depleting
deplore	deplored	deplored	deploring
deploy	deployed	deployed	deploying
depose	deposed	deposed	deposing
deposit	deposited	deposited	depositing
deprave	depraved	depraved	depraving
deprecate	deprecated	deprecated	deprecating
depreciate	depreciated	depreciated	depreciating
depredate	depredated	depredated	depredating
depress	depressed	depressed	depressing
deprive	deprived	deprived	depriving
depute	deputed	deputed	deputing
deride	derided	derided	deriding
derive	derived	derived	deriving
descend	descended	descended	descending
descent	descented	descented	descenting
describe	described	described	describing
descry	descried	descried	descrying
desert	deserted	deserted	deserting
deserve	deserved	deserved	deserving
desiccate	desiccated	desiccated	desiccating
design	designed	designed	designing
designate	designated	designated	designating
desire	desired	desired	desiring
desist	desisted	desisted	desisting
despair	despaired	despaired	despairing
despatch	despatched	despatched	despatching
despise	despised	despised	despising
despoil	despoiled	despoiled	despoiling
destine	destined	destined	destining
destroy	destroyed	destroyed	destroying
detach	detached	detached	detaching
detain	detained	detained	detaining
detect	detected	detected	detecting
deter	deterred	deterred	deterring
deteriorate	deteriorated	deteriorated	deteriorating
determine	determined	determined	determining
detest	detested	detested	detesting
detonate	detonated	detonated	detonating
detract	detracted	detracted	detracting
devalue	devalued	devalued	devaluing
develop	developed	developed	developing
devise	devised	devised	devising
devote	devoted	devoted	devoting
devour	devoured	devoured	devouring
diagnose	diagnosed	diagnosed	diagnosing
dial	dialled	dialled	dialling
dictate	dictated	dictated	dictating
diddle	diddled	diddled	diddling
die	died	died	dying
differ	differed	differed	differing
differentiate	differentiated	differentiated	differentiating
dig	dug	dug	digging
digest	digested	digested	digesting
dignify	dignified	dignified	dignifying
digress	digressed	digressed	digressing
dim	dimmed	dimmed	dimming
diminish	diminished	diminished	diminishing
dine	dined	dined	dining
ding	dinged	dinged	dinging
dip	dipped	dipped	dipping
direct	directed	directed	directing
dirty	dirtied	dirtied	dirtying
disagree	disagreed	disagreed	disagreeing
disappear	disappeared	disappeared	disappearing
disappoint	disappointed	disappointed	disappointing
disapprove	disapproved	disapproved	disapproving
disband	disbanded	disbanded	disbanding
disbelieve	disbelieved	disbelieved	disbelieving
discard	discarded	discarded	discarding
discern	discerned	discerned	discerning
discharge	discharged	discharged	discharging
disclaim	disclaimed	disclaimed	disclaiming
disclose	disclosed	disclosed	disclosing
disconcert	disconcerted	disconcerted	disconcerting
disconnect	disconnected	disconnected	disconnecting
discontinue	discontinued	discontinued	discontinuing
discount	discounted	discounted	discounting
discourage	discouraged	discouraged	discouraging
discover	discovered	discovered	discovering
discuss	discussed	discussed	discussing
disdain	disdained	disdained	disdaining
disembark	disembarked	disembarked	disembarking
disembody	disembodied	disembodied	disembodying
disembowel	disemboweled	disemboweled	disemboweling
disgrace	disgraced	disgraced	disgracing
disguise	disguised	disguised	disguising
disgust	disgusted	disgusted	disgusting
dishonour	dishonoured	dishonoured	dishonouring
disinter	disinterred	disinterred	disinterring
dislike	disliked	disliked	disliking
dislocate	dislocated	dislocated	dislocating
dismiss	dismissed	dismissed	dismissing
dismount	dismounted	dismounted	dismounting
disobey	disobeyed	disobeyed	disobeying
disown	disowned	disowned	disowning
dispatch	dispatched	dispatched	dispatching
dispel	dispelled	dispelled	dispelling
dispence	dispenced	dispenced	dispencing
dispense	dispensed	dispensed	dispensing
disperse	dispersed	dispersed	dispersing
displace	displaced	displaced	displacing
display	displayed	displayed	displaying
disport	disported	disported	disporting
dispose	disposed	disposed	disposing
disprove	disproved	disproved	disproving
dispute	disputed	disputed	disputing
disqualify	disqualifyed	disqualifyed	disqualifying
disregard	disregarded	disregarded	disregarding
disrupt	disrupted	disrupted	disrupting
dissatisfy	dissatisfyed	dissatisfyed	dissatisfying
dissect	dissected	dissected	dissecting
dissent	dissented	dissented	dissenting
dissolve	dissolved	dissolved	dissolving
dissuade	dissuaded	dissuaded	dissuading
distend	distended	distended	distending
distil	distilled	distilled	distilling
distinguish	distinguished	distinguished	distinguishing
distort	distorted	distorted	distorting
distract	distracted	distracted	distracting
distress	distressed	distressed	distressing
distribute	distributed	distributed	distributing
disturb	disturbed	disturbed	disturbing
divagate	divagated	divagated	divagating
dive	dived	dived	diving
divert	diverted	diverted	diverting
divest	divested	divested	divesting
divide	divided	divided	dividing
divorce	divorced	divorced	divorcing
do	did	done	doing
dock	docked	docked	docking
doctor	doctored	doctored	doctoring
dodder	doddered	doddered	doddering
dodge	dodged	dodged	dodging
doff	doffed	doffed	doffing
dominate	dominated	dominated	dominating
domineer	domineered	domineered	domineering
don	donned	donned	donning
donate	donated	donated	donating
doom	doomed	doomed	dooming
double	doubled	doubled	doubling
doubt	doubted	doubted	doubting
down	downed	downed	downing
download	downloaded	downloaded	downloading
doze	dozed	dozed	dozing
draft	drafted	drafted	drafting
drag	draged	draged	draging
draggle	draggled	draggled	draggling
drain	drained	drained	draining
dramatize	dramatized	dramatized	dramatizing
drape	draped	draped	draping
draw	drew	drawn	drawing
drawl	drawled	drawled	drawling
dream	dreamed / dreamt	dreamed / dreamt	dreaming
drench	drenched	drenched	drenching
dress	dressed	dressed	dressing
drift	drifted	drifted	drifting
drill	drilled	drilled	drilling
drink	drank	drunk	drinking
drip	dripped	dripped	dripping
drive	drove	driven	driving
drivel	driveled	driveled	driveling
drizzle	drizzled	drizzled	drizzling
drone	droned	droned	droning
drool	drooled	drooled	drooling
droop	drooped	drooped	drooping
drop	droped	droped	droping
drown	drowned	drowned	drowning
drum	drummed	drummed	drumming
dry	dried	dried	drying
dub	dubbed	dubbed	dubbing
duck	ducked	ducked	ducking
dull	dulled	dulled	dulling
dumb found	dumb founded	dumb founded	dumb founding
dump	dump ed	dump ed	dump ing
dupe	duped	duped	duping
dust	dusted	dusted	dusting
dwell	dwelt / dwelled	dwelt / dwelled	dwelling
dwindle	dwindled	dwindled	dwindling
dye	dyed	dyed	dyeing
earn	earned	earned	earning
ease	eased	eased	easing
ease	eased	eased	easing
eat	ate	eaten	eating
ebb	ebbed	ebbed	ebbing
echo	echoed	echoed	echoing
economize	economized	economized	economizing
edge	edged	edged	edging
edify	edified	edified	edifying
edit	edited	edited	editing
educate	educated	educated	educating
effect	effected	effected	effecting
egg	egged	egged	egging
ejaculate	ejaculated	ejaculated	ejaculating
eject	ejected	ejected	ejecting
eke	eked	eked	eking
elaborate	elaborated	elaborated	elaborating
elect	elected	elected	electing
electrify	electrified	electrified	electrifying
electrocute	electrocuted	electrocuted	electrocuting
electroplate	electroplated	electroplated	electroplating
elicit	elicited	elicited	eliciting
elongate	elongated	elongated	elongating
elope	eloped	eloped	eloping
elucidate	elucidated	elucidated	elucidating
elude	eluded	eluded	eluding
embark	embarked	embarked	embarking
embarrass	embarrassed	embarrassed	embarrassing
embellish	embellished	embellished	embellishing
embitter	embittered	embittered	embittering
embody	embodied	embodied	embodying
emboss	embossed	embossed	embossing
embrace	embraced	embraced	embracing
embrak	embraked	embraked	embraking
embroil	embroiled	embroiled	embroiling
embus	embussed	embussed	embussing
emend	emended	emended	emending
emerge	emerged	emerged	emerging
emigrate	emigrated	emigrated	emigrating
emit	emitted	emitted	emitting
empanel	empaneled	empaneled	empaneling
emphasize	emphasized	emphasized	emphasizing
employ	employed	employed	employing
empower	empowered	empowered	empowering
empty	emptied	emptied	emptying
enable	enabled	enabled	enabling
enact	enacted	enacted	enacting
enamel	enameled	enameled	enameling
enamour	enamoured	enamoured	enamouring
encamp	encamped	encamped	encamping
encase	encased	encased	encasing
encash	encashed	encashed	encashing
enchain	enchained	enchained	enchaining
enchant	enchanted	enchanted	enchanting
encircle	encircled	encircled	encircling
enclose	enclosed	enclosed	enclosing
encompass	encompassed	encompassed	encompassing
encounter	encountered	encountered	encountering
encourage	encouraged	encouraged	encouraging
encroach	encroached	encroached	encroaching
encumber	encumbered	encumbered	encumbering
end	ended	ended	ending
end	ended	ended	ending
endanger	endangered	endangered	endangering
endear	endeared	endeared	endearing
endeavour	endeavoured	endeavoured	endeavouring
endorse	endorsed	endorsed	endorsing
endow	endowed	endowed	endowing
endure	endured	endured	enduring
enfold	enfolded	enfolded	enfolding
enforce	enforced	enforced	enforcing
engage	engaged	engaged	engaging
engender	engendered	engendered	engendering
engrave	engraved	engraved	engraving
engross	engrossed	engrossed	engrossing
engulf	engulfed	engulfed	engulfing
enhance	enhanced	enhanced	enhancing
enjoin	enjoined	enjoined	enjoining
enjoy	enjoyed	enjoyed	enjoying
enlarge	enlarged	enlarged	enlarging
enlighten	enlightened	enlightened	enlightening
enlist	enlisted	enlisted	enlisting
enmesh	enmeshed	enmeshed	enmeshing
enquire	enquired	enquired	enquiring
enrich	enriched	enriched	enriching
enrol	enroled	enroled	enroling
enroll	enrolled	enrolled	enrolling
enshroud	enshrouded	enshrouded	enshrouding
enslave	enslaved	enslaved	enslaving
ensure	ensured	ensured	ensuring
entail	entailed	entailed	entailing
enter	entered	entered	entering
entertain	entertained	entertained	entertaining
enthrall	enthralled	enthralled	enthralling
enthrone	enthroned	enthroned	enthroning
entitle	entitled	entitled	entitling
entrap	entrapped	entrapped	entrapping
entreat	entreated	entreated	entreating
entrust	entrusted	entrusted	entrusting
enunciate	enunciated	enunciated	enunciating
envelop	enveloped	enveloped	enveloping
envenom	envenomed	envenomed	envenoming
envy	envied	envied	envying
enwrap	enwrapped	enwrapped	enwrapping
equal	equalled	equalled	equalling
equip	equipped	equipped	equipping
eradicate	eradicated	eradicated	eradicating
erase	erased	erased	erasing
erect	erected	erected	erecting
erode	eroded	eroded	eroding
err	erred	erred	erring
erupt	erupted	erupted	erupting
escape	escaped	escaped	escaping
eschew	eschewed	eschewed	eschewing
escort	escorted	escorted	escorting
espy	espied	espied	espying
establish	established	established	establishing
esteem	esteemed	esteemed	esteeming
estimate	estimated	estimated	estimating
etch	etched	etched	etching
eulogize	eulogized	eulogized	eulogizing
evacuate	evacuated	evacuated	evacuating
evade	evaded	evaded	evading
evaporate	evaporated	evaporated	evaporating
even	evened	evened	evening
evict	evicted	evicted	evicting
evoke	evoked	evoked	evoking
evolve	evolved	evolved	evolving
exact	exacted	exacted	exacting
exaggerate	exaggerated	exaggerated	exaggerating
exalt	exalted	exalted	exalting
examine	examined	examined	examining
exceed	exceeded	exceeded	exceeding
excel	excelled	excelled	excelling
except	excepted	excepted	excepting
exchange	exchanged	exchanged	exchanging
excite	excited	excited	exciting
exclaim	exclaimed	exclaimed	exclaiming
exclude	excluded	excluded	excluding
excuse	excused	excused	excusing
execute	executed	executed	executing
exemplify	exemplified	exemplified	exemplifying
exempt	exempted	exempted	exempting
exercise	exercised	exercised	exercising
exert	exerted	exerted	exerting
exhale	exhaled	exhaled	exhaling
exhaust	exhausted	exhausted	exhausting
exhibit	exhibited	exhibited	exhibiting
exhort	exhorted	exhorted	exhorting
exile	exiled	exiled	exiling
exist	existed	existed	existing
exorcise	exorcised	exorcised	exorcising
expand	expanded	expanded	expanding
expect	expected	expected	expecting
expedite	expedited	expedited	expediting
expel	expelled	expelled	expelling
expend	expended	expended	expending
experience	experienced	experienced	experiencing
experiment	experimented	experimented	experimenting
expiate	expiated	expiated	expiating
expire	expired	expired	expiring
explain	explained	explained	explaining
explode	exploded	exploded	exploding
exploit	exploited	exploited	exploiting
explore	explored	explored	exploring
export	exported	exported	exporting
expose	exposed	exposed	exposing
expound	expounded	expounded	expounding
express	expressed	expressed	expressing
expunge	expunged	expunged	expunging
expurgate	expurgated	expurgated	expurgating
extend	extended	extended	extending
extinguish	extinguished	extinguished	extinguishing
extol	extolled	extolled	extolling
extort	extorted	extorted	extorting
extract	extracted	extracted	extracting
extricate	extricated	extricated	extricating
exult	exulted	exulted	exulting
fabricate	fabricated	fabricated	fabricating
face	faced	faced	facing
facilitate	facilitated	facilitated	facilitating
fade	faded	faded	fading
fag	fagged	fagged	fagging
fail	failed	failed	failing
faint	fainted	fainted	fainting
fall	fell	fallen	falling
falsify	falsified	falsified	falsifying
falter	faltered	faltered	faltering
famish	famished	famished	famishing
fan	fanned	fanned	fanning
fancy	fancied	fancied	fancying
fare	fared	fared	faring
farm	farmed	farmed	farming
farrow	farrowed	farrowed	farrowing
fascinate	fascinated	fascinated	fascinating
fashion	fashioned	fashioned	fashioning
fast	fasted	fasted	fasting
fasten	fastened	fastened	fastening
faster	fastered	fastered	fastering
fat	fatted	fatted	fatting
fate	fated	fated	fating
fatten	fattened	fattened	fattening
favour	favoured	favoured	favouring
fawn	fawned	fawned	fawning
fear	feared	feared	fearing
feast	feasted	feasted	feasting
feed	fed	fed	feeding
feel	felt	felt	feeling
felicitate	felicitated	felicitated	felicitating
fell	felled	felled	felling
fence	fenced	fenced	fencing
fend	fended	fended	fending
ferment	fermented	fermented	fermenting
ferry	ferried	ferried	ferrying
fertilize	fertilized	fertilized	fertilizing
fetch	fetched	fetched	fetching
fidget	fidgeted	fidgeted	fidgeting
field	fielded	fielded	fielding
fight	fought	fought	fighting
figure	figured	figured	figuring
filch	filched	filched	filching
file	filed	filed	filing
fill	filled	filled	filling
film	filmed	filmed	filming
filter	filtered	filtered	filtering
filtrate	filtrated	filtrated	filtrating
finalize	finalized	finalized	finalizing
finance	financed	financed	financing
find	finded	finded	finding
finish	finished	finished	finishing
fire	fired	fired	firing
fish	fished	fished	fishing
fit	fitted	fitted	fitting
fix	fixed	fixed	fixing
fizzle	fizzled	fizzled	fizzling
flabbergast	flabbergasted	flabbergasted	flabbergasting
flag	flagged	flagged	flagging
flame	flamed	flamed	flaming
flap	flapped	flapped	flapping
flash	flashed	flashed	flashing
flatten	flattened	flattened	flattening
flatter	flattered	flattered	flattering
flaunt	flaunted	flaunted	flaunting
flavour	flavoured	flavoured	flavouring
flay	flayed	flayed	flaying
flee	fled	fled	fleeing
fleece	fleeced	fleeced	fleecing
flick	flicked	flicked	flicking
flicker	flickered	flickered	flickering
flinch	flinched	flinched	flinching
fling	flung	flung	flinging
flip	flipped	flipped	flipping
flirt	flirted	flirted	flirting
flit	flitted	flitted	flitting
flitter	flittered	flittered	flittering
float	floated	floated	floating
flog	flogged	flogged	flogging
flood	flooded	flooded	flooding
floor	floored	floored	flooring
flop	flopped	flopped	flopping
flounder	floundered	floundered	floundering
flourish	flourished	flourished	flourishing
flout	flouted	flouted	flouting
flow	flowed	flowed	flowing
fluctuate	fluctuated	fluctuated	fluctuating
flunk	flunked	flunked	flunking
flush	flushed	flushed	flushing
fluster	flustered	flustered	flustering
flute	fluted	fluted	fluting
flutter	fluttered	fluttered	fluttering
fly	flew	flown	flying
focus	focused	focused	focusing
fog	fogged	fogged	fogging
foil	foiled	foiled	foiling
fold	folded	folded	folding
follow	followed	followed	following
fondle	fondled	fondled	fondling
fool	fooled	fooled	fooling
foozle	foozled	foozled	foozling
forbear	forbore	forborne	forbearing
forbid	forbade	forbidden	forbidding
force	forced	forced	forcing
ford	forded	forded	fording
fore stall	fore stalled	fore stalled	fore stalling
forebode	foreboded	foreboded	foreboding
forecast	forecast	forecast	forecasting
forego	forewent	foregone	foregoing
foreordain	foreordained	foreordained	foreordaining
foresee	foresaw	foreseen	foreseeing
foretell	foretold	foretold	foretelling
forfeit	forfeited	forfeited	forfeiting
forget	forgot	fotgotten	forgetting
forgive	forgave	forgiven	forgiving
fork	forked	forked	forking
form	formed	formed	forming
formulate	formulated	formulated	formulating
forsake	forsook	forsaken	forsaking
forswear	forswore	forsworm	forswearing
fortify	fortified	fortified	fortifying
forward	forwarded	forwarded	forwarding
foster	fostered	fostered	fostering
found	founded	founded	founding
founder	foundered	foundered	foundering
fracture	fractured	fractured	fracturing
frame	framed	framed	framing
frank	franked	franked	franking
fraternize	fraternized	fraternized	fraternizing
fray	frayed	frayed	fraying
freckle	freckled	freckled	freckling
free	freed	freed	freeing
freeze	froze	forzen	freezing
frequent	frequented	frequented	frequenting
fret	fretted	fretted	fretting
frighten	frightened	frightened	frightening
frisk	frisked	frisked	frisking
frizzle	frizzled	frizzled	frizzling
frown	frowned	frowned	frowning
fructify	fructified	fructified	fructifying
fry	fried	fried	frying
fub	fubbed	fubbed	fubbing
fudge	fudged	fudged	fudging
fuel	fuelled	fuelled	fuelling
fulfil	fulfilled	fulfilled	fulfilling
fulminate	fulminated	fulminated	fulminating
fumble	fumbled	fumbled	fumbling
function	functioned	functioned	functioning
furbish	furbished	furbished	furbishing
furl	furled	furled	furling
furnish	furnished	furnished	furnishing
fuse	fused	fused	fusing
fustigate	fustigated	fustigated	fustigating
gab	gabbed	gabbed	gabbing
gabble	gabbled	gabbled	gabbling
gad	gaded	gaded	gading
gag	gagged	gagged	gagging
gaggle	gaggled	gaggled	gaggling
gain	gained	gained	gaining
gainsay	gainsaid	gainsaid	gainsaying
gall	galled	galled	galling
gallivant	gallivanted	gallivanted	gallivanting
gallop	galloped	gallop	galloping
gam	gammed	gammed	gamming
gamble	gambled	gambled	gambling
game	gamed	gamed	gaming
gap	gapped	gapped	gapping
gape	gaped	gaped	gaping
garble	garbled	garbled	garbling
gargle	gargled	gargled	gargling
garland	garlanded	garlanded	garlanding
garner	garnered	garnered	garnering
garnish	garnished	garnished	garnishing
gas	gassed	gassed	gassing
gasconade	gasconaded	gasconaded	gasconading
gasp	gasped	gasped	gasping
gather	gathered	gathered	gathering
gaze	gazed	gazed	gazing
gazette	gazetted	gazetted	gazetting
generalize	generalized	generalized	generalizing
generate	generated	generated	generating
germinate	germinated	germinated	germinating
gestate	gestated	gestated	gestating
gesticulate	gesticulated	gesticulated	gesticulating
get	got	got / gotten	getting
gibber	gibbered	gibbered	gibbering
gibe	gibed	gibed	gibing
gift	gifted	gifted	gifting
giggle	giggled	giggled	giggling
gild	gilded	gilded	gilding
girdle	girdled	girdled	girdling
give	gave	given	giving
glance	glanced	glanced	glancing
glare	glared	glared	glaring
glaze	glazed	glazed	glazing
gleam	gleamed	gleamed	gleaming
glean	gleaned	gleaned	gleaning
glide	glided	glided	gliding
glimmer	glimmered	glimmered	glimmering
glint	glinted	glinted	glinting
glisten	glistened	glistened	glistening
glister	glistered	glistered	glistering
glitter	glittered	glittered	glittering
gloat	gloated	gloated	gloating
glorify	glorified	glorified	glorifying
gloss	glossed	glossed	glossing
gloue	glued	glued	gluing
glow	glowed	glowed	glowing
glue	glued	glued	gluing
gnarl	gnarled	gnarled	gnarling
gnash	gnashed	gnashed	gnashing
gnaw	gnawed	gnawed	gnawing
go	went	gone	going
goggle	goggled	goggled	goggling
gore	gored	gored	goring
gossip	gossiped	gossiped	gossiping
govern	governed	governed	governing
grab	grabbed	grabbed	grabbing
grace	graced	graced	gracing
grade	graded	graded	grading
graduate	graduated	graduated	graduating
graft	grafted	grafted	grafting
grant	granted	granted	granting
grapple	grappled	grappled	grappling
grasp	grasped	grasped	grasping
grate	grated	grated	grating
gratify	gratified	gratified	gratifying
graze	grazed	grazed	grazing
grease	greased	greased	greasing
greet	greeted	greeted	greeting
grieve	grieved	grieved	grieving
grieve	grieved	grieved	grieving
grill	grilled	grilled	grilling
grimace	grimaced	grimaced	grimacing
grin	grinned	grinned	grinning
grind	ground	ground	grinding
grip	gripped	gripped	gripping
groan	groaned	groaned	groaning
groom	groomed	groomed	grooming
grope	groped	groped	groping
ground	grounded	grounded	grounding
group	grouped	grouped	grouping
grouse	groused	groused	grousing
grow	grew	grown	growing
growl	growled	growled	growling
grudge	grudged	grudged	grudging
grumble	grumbled	grumbled	grumbling
grunt	grunted	grunted	grunting
guard	guarded	guarded	guarding
guess	guessed	guessed	guessing
guffaw	guffawed	guffawed	guffawing
guide	guided	guided	guiding
gull	gulled	gulled	gulling
gulp	gulped	gulped	gulping
gush	gushed	gushed	gushing
guzzle	guzzled	guzzled	guzzling
gyrate	gyrated	gyrated	gyrating
hack	hacked	hacked	hacking
haggle	haggled	haggled	haggling
hagride	hagrode	hagridden	hagriding
hail	hailed	hailed	hailing
hale	haled	haled	haling
hallow	hallowed	hallowed	hallowing
halt	halted	halted	halting
halve	halved	halved	halving
hammer	hammered	hammered	hammering
hamper	hampered	hampered	hampering
hand	handed	handed	handing
handle	handled	handled	handling
hang	hung	hung	hanging
hanker	hankered	hankered	hankering
happen	happened	happened	happening
harass	harassed	harassed	harassing
harbor	harbored	harbored	harboring
harden	hardened	hardened	hardening
hark	harked	harked	harking
harm	harmed	harmed	harming
harvest	harvested	harvested	harvesting
has	had	had	having
hash	hashed	hashed	hashing
hasten	hastened	hastened	hastening
hatch	hatched	hatched	hatching
hate	hated	hated	hating
haul	hauled	hauled	hauling
haunt	haunted	haunted	haunting
have	had	had	having
hawk	hawked	hawked	hawking
hazard	hazarded	hazarded	hazarding
head	headed	headed	heading
heal	healed	healed	healing
heap	heaped	heaped	heaping
hear	heard	heard	hearing
hearken	hearkened	hearkened	hearkening
hearten	heartened	heartened	heartening
heat	heated	heated	heating
heave	heaved	heaved	heaving
hedge	hedged	hedged	hedging
heed	heeded	heeded	heeding
help	helped	helped	helping
hesitate	hesitated	hestitated	hestitating
hew	hewed / hewn	hewed	hewing
hide	hid	hidden	hiding
high light	high lighted	high lighted	high lighting
hijack	hijacked	hijacked	hijacking
hinder	hindered	hindered	hindering
hint	hinted	hinted	hinting
hire	hired	hired	hiring
hiss	hissed	hissed	hissing
hit	hit	hit	hitting
hitch	hitched	hitched	hitching
hoard	hoarded	hoarded	hoarding
hoax	hoaxed	hoaxed	hoaxing
hobble	hobbled	hobbled	hobbling
hocus	hocused	hocused	hocusing
hoist	hoisted	hoisted	hoisting
hold	held	held	holding
hole	holed	holed	holing
hollow	hollowed	hollowed	hollowing
honour	honoured	honoured	honouring
hook	hooked	hooked	hooking
hop	hopped	hopped	hopping
hope	hoped	hoped	hoping
horripilate	horripilated	horripilated	horripilating
host	hosted	hosted	hosting
hover	hovered	hovered	hovering
howl	howled	howled	howling
hug	hugged	hugged	hugging
hum	hummed	hummed	humming
humiliate	humiliated	humiliated	humiliating
hunt	hunted	hunted	hunting
hurl	hurled	hurled	hurling
hurry	hurried	hurried	hurring
hurt	hurt	hurt	hurting
hush	hushed	hushed	hushing
husk	husked	husked	husking
hypothecate	hypothecated	hypothecated	hypothecating
ice	iced	iced	icing
idealize	idealized	idealized	idealizing
identify	identified	identified	identifying
idle	idled	idled	idling
ignite	ignited	ignited	igniting
ignore	ignored	ignored	ignoring
illminate	illminated	illminated	illminating
illuminate	illuminated	illuminated	illuminating
illustrate	illustrated	illustrated	illustrating
imagine	imagined	imagined	imagining
imbibe	imbibed	imbibed	imbibing
imitate	imitated	imitated	imitating
imitate	imitated	imitated	imitating
immerse	immersed	immersed	immersing
immigrate	immigrated	immigrated	immigrating
immolate	immolated	immolated	immolating
immunize	immunized	immunized	immunizing
immure	immured	immured	immuring
impair	impaired	impaired	impairing
imparadise	imparadised	imparadised	imparadising
impart	imparted	imparted	imparting
impassion	impassioned	impassioned	impassioning
impeach	impeached	impeached	impeaching
impel	impelled	impelled	impelling
impersonate	impersonated	impersonated	impersonating
impinge	impinged	impinged	impinging
implement	implemented	implemented	implementing
implicate	implicated	implicated	implicating
implore	implored	implored	imploring
imply	implied	implied	implying
import	imported	imported	importing
importune	importuned	importuned	importuning
impose	imposed	imposed	imposing
impound	impounded	impounded	impounding
impoverish	impoverished	impoverished	impoverishing
imprecate	imprecated	imprecated	imprecating
impress	impressed	impressed	impressing
imprint	imprinted	imprinted	imprinting
imprison	imprisonimprisoned	ed	imprisoning
improve	improved	improved	improving
impugn	impugned	impugned	impugning
impute	imputed	imputed	imputing
inaugurate	inaugurated	inaugurated	inaugurating
incarnate	incarnated	incarnated	incarnating
incense	incensed	incensed	incensing
incise	incised	incised	incising
incite	incited	incited	inciting
incline	inclined	inclined	inclining
include	included	included	including
increase	increased	increased	increasing
incriminate	incriminated	incriminated	incriminating
inculcate	inculcated	inculcated	inculcating
incur	incurred	incurred	incurring
indemnify	indemnified	indemnified	indemnifying
indent	indented	indented	indenting
indicate	indicated	indicated	indicating
indict	indicted	indicted	indicting
indite	indited	indited	inditing
induce	induced	induced	inducing
indulge	indulged	indulged	indulging
infect	infected	infected	infecting
infer	inferred	inferred	inferring
infest	infested	infested	infesting
infiltrate	infiltrated	infiltrated	infiltrating
inflame	inflamed	inflamed	inflaming
inflect	inflected	inflected	inflecting
inflict	inflicted	inflicted	inflicting
influence	influenced	influenced	influencing
inform	informed	informed	informing
infringe	infringed	infringed	infringing
infuse	infused	infused	infusing
inhabit	inhabited	inhabited	inhabiting
inhale	inhaled	inhaled	inhaling
inherit	inherited	inherited	inheriting
inhibit	inhibited	inhibited	inhibiting
initiate	initiated	initiated	initiating
inject	injected	injected	injecting
injure	injured	injured	injuring
inlay	inlaid	inlaid	inlaying
innovate	innovated	innovated	innovating
inoculate	inoculated	inoculated	inoculating
inquire	inquired	inquired	inquiring
inscribe	inscribed	inscribed	inscribing
insert	inserted	inserted	inserting
insinuate	insinuated	insinuated	insinuating
insist	insisted	insisted	insisting
inspect	inspected	inspected	inspecting
inspire	inspired	inspired	inspiring
install	installed	installed	installing
instil	instilled	instilled	instilling
instruct	instructed	instructed	instructing
insult	insulted	insulted	insulting
insure	insured	insured	insuring
integrate	integrated	integrated	integrating
intend	intended	intended	intending
intensify	intensified	intensified	intensifying
inter lock	inter locked	inter locked	inter locking
intercalate	intercalated	intercalated	intercalating
intercept	intercepted	intercepted	intercepting
interchange	interchanged	interchanged	interchanging
interest	interested	interested	interesting
interfere	interfered	interfered	interfering
interlink	interlinked	interlinked	interlinking
interpret	interpreted	interpreted	interpreting
interrupt	interrupted	interrupted	interrupting
intersect	intersected	intersected	intersecting
intervene	intervened	intervened	intervening
interview	interviewed	interviewed	interviewing
interweave	interwove	interwoven	interweaving
intimate	intimated	intimated	intimating
intoxicate	intoxicated	intoxicated	intoxicating
intrigue	intrigued	intrigued	intriguing
introduce	introduced	introduced	introducing
introvert	introverted	introverted	introverting
intrude	intruded	intruded	intruding
invade	invaded	invaded	invading
inveigh	inveighed	inveighed	inveighing
invent	invented	invented	inventing
invert	inverted	inverted	inverting
invest	invested	invested	investing
investigate	investigated	investigated	investigating
invigorate	invigorated	invigorated	invigorating
invite	invited	invited	inviting
invoke	invoked	invoked	invoking
involve	involved	involved	involving
iron	ironed	ironed	ironing
irrigate	irrigated	irrigated	irrigating
irritate	irritated	irritated	irritating
isolate	isolated	isolated	isolating
issue	issued	issued	issuing
italicize	italicized	italicized	italicizing
itch	itched	itched	itching
jab	jabbed	jabbed	jabbing
jabber	jabbered	jabbered	jabbering
jack	jacked	jacked	jacking
jam	jammed	jammed	jamming
jazz	jazzed	jazzed	jazzing
jeopardize	jeopardized	jeopardized	jeopardizing
jerk	jerked	jerked	jerking
jilt	jilted	jilted	jilting
join	joined	joined	joining
joke	joked	joked	joking
jolt	jolted	jolted	jolting
jot	jotted	jotted	jotting
journey	journeyed	journeyed	journeying
joust	jousted	jousted	jousting
judge	judged	judged	judging
juggle	juggled	juggled	juggling
jumble	jumbled	jumbled	jumbling
jump	jumped	jumped	jumping
justify	justified	justified	justifying
keep	kept	kept	keeping
ken	kenned	kenned	kenning
key	keyed	keyed	keying
kick	kicked	kicked	kicking
kidnap	kidnapped	kidnapped	kidnapping
kill	killed	killed	killing
kindle	kindled	kindled	kindling
kiss	kissed	kissed	kissing
knead	kneaded	kneaded	kneading
kneel	knelt	knelt	kneeling
knight	knighted	knighted	knighting
knit	knited	knited	kniting
knock	knocked	knocked	knocking
know	knew	knew	knowing
label	labelled	labelled	labelling
labour	laboured	laboured	labouring
lacerate	lacerated	lacerated	lacerating
lack	lacked	lacked	lacking
lag	lagged	lagged	lagging
lament	lamented	lamented	lamenting
lance	lanced	lanced	lancing
lancinate	lancinated	lancinated	lancinating
land	landed	landed	landing
languish	languished	languished	languishing
lap	lapped	lapped	lapping
lapidify	lapidified	lapidified	lapidifying
lapse	lapsed	lapsed	lapsing
lash	lashed	lashed	lashing
last	lasted	lasted	lasting
laud	lauded	lauded	lauding
laugh	laughed	laughed	laughing
launch	launched	launched	launching
launder	laundered	laundered	laundering
lay	laid	laid	laying
leach	leached	leached	leaching
lead	led	led	leading
leak	leaked	leaked	leaking
lean	leaned / leant	leaned / leant	leaning
leap	leaped / leapt	leaped / leapt	leaping
learn	learned / learnt	learned / learnt	learning
lease	leased	leased	leasing
leave	left	left	leaving
lecture	lectured	lectured	lecturing
legalize	legalized	legalized	legalizing
legislate	legislated	legislated	legislating
lend	lent	lent	lending
lessen	lessened	lessened	lessening
let	let	let	letting
level	levelled	levelled	levelling
lever	levered	levered	levering
levitate	levitated	levitated	levitating
levy	levied	levied	levying
liberate	liberated	liberated	liberating
licence	licenced	licenced	licencing
license	licensed	licensed	licensing
lick	licked	licked	licking
lie	lied / lay	lied / lain	liying
lift	lifted	lifted	lifting
light	lighted / lit	lighted / lit	lighting
like	liked	liked	liking
limit	limited	limited	limiting
limp	limped	limped	limping
line	lined	lined	lining
linger	lingered	lingered	lingering
link	linked	linked	linking
link	linked	linked	linking
list	listed	listed	listing
listen	listened	listened	listening
litter	littered	littered	littering
live	lived	lived	living
liven	livened	livened	livening
load	loaded	loaded	loading
loaf	loafed	loafed	loafing
locate	located	located	locating
lock	locked	locked	locking
lodge	lodged	lodged	lodging
long	longed	longed	longing
look	looked	looked	looking
loom	loomed	loomed	looming
loose	loosed	loosed	loosing
loosen	loosened	loosened	loosening
loot	looted	looted	looting
lop	lopped	lopped	lopping
lose	lost	lost	losing
love	loved	loved	loving
lower	lowered	lowered	lowering
lubricate	lubricated	lubricated	lubricating
lug	lugged	lugged	lugging
lull	lulled	lulled	lulling
lunch	lunched	lunched	lunching
lynch	lynched	lynched	lynching
magnetize	magnetized	magnetized	magnetizing
magnify	magnified	magnified	magnifying
mail	mailed	mailed	mailing
maim	maimed	maimed	maiming
maintain	maintained	maintained	maintaining
make	made	made	making
malign	maligned	maligned	maligning
maltreat	maltreated	maltreated	maltreating
maltreat	maltreated	maltreated	maltreating
man	manned	manned	manning
manage	managed	managed	managing
mangle	mangled	mangled	mangling
manicure	manicured	manicured	manicuring
manifest	manifested	manifested	manifesting
manufacture	manufactured	manufactured	manufacturing
map	mapped	mapped	mapping
mar	marred	marred	marring
maraud	marauded	marauded	marauding
march	marched	marched	marching
mark	marked	marked	marking
market	marketed	marketed	marketing
maroon	marooned	marooned	marooning
marry	married	married	marrying
marvel	marvelled	marvelled	marvelling
mask	masked	masked	masking
master	mastered	mastered	mastering
masticate	masticated	masticated	masticating
match	matched	matched	matching
matter	mattered	mattered	mattering
mature	matured	matured	maturing
maul	mauled	mauled	mauling
mean	meant	meant	meaning
meander	meandered	meandered	meandering
measure	measured	measured	measuring
meddle	meddled	meddled	meddling
medicate	medicated	medicated	medicating
meditate	meditated	meditated	meditating
meet	met	met	meeting
melt	melted	melted	melting
memorize	memorized	memorized	memorizing
mend	mended	mended	mending
mention	mentioned	mentioned	mentioning
merge	merged	merged	merging
mete	meted	meted	meting
meterizlize	meterizlized	meterizlized	meterizlizing
mew	mewed	mewed	mewing
migrate	migrated	migrated	migrating
milk	milked	milked	milking
mimic	mimicked	mimicked	mimicking
mince	minced	minced	mincing
mind	minded	minded	minding
mine	mined	mined	mining
mingle	mingled	mingled	mingling
minimize	minimized	minimized	minimizing
minister	ministered	ministered	ministering
mint	minted	minted	minting
mirror	mirrored	mirrored	mirroring
misappropriate	misappropriated	misappropriated	misappropriating
misbehave	misbehaved	misbehaved	misbehaving
misconstrue	misconstrued	misconstrued	misconstruing
miscount	miscounted	miscounted	miscounting
misdeal	misdealt	misdealt	misdealing
misdirect	misdirected	misdirected	misdirecting
misgive	misgave	misgiven	misgiving
misinform	misinformed	misinformed	misinforming
misinterpret	misinterpreted	misinterpreted	misinterpreting
mislead	misled	misled	misleading
misplace	misplaced	misplaced	misplacing
miss	missed	missed	missing
misspend	misspent	misspent	misspending
mistake	mistook	mistaken	mistaking
mistrust	mistrusted	mistrusted	mistrusting
misunderstand	misunderstood	misunderstood	misunderstanding
misuse	misused	misused	misusing
mix	mixed	mixed	mixing
moan	moaned	moaned	moaning
mobilize	mobilized	mobilized	mobilizing
mock	mocked	mocked	mocking
model	modelled	modelled	modelling
modernize	modernized	modernized	modernizing
modify	modified	modified	modifying
modulate	modulated	modulated	modulating
moisten	moistened	moistened	moistening
molest	molested	molested	molesting
molt	molted	molted	molting
monitor	monitored	monitored	monitoring
moon	mooned	mooned	mooning
moor	moored	moored	mooring
mop	mopped	mopped	mopping
mortgage	mortgaged	mortgaged	mortgaging
mortify	mortified	mortified	mortifying
motion	motioned	motioned	motioning
mottle	mottled	mottled	mottling
mould	moulded	moulded	moulding
moum	moumed	moumed	mouming
mount	mounted	mounted	mounting
mourn	mourned	mourned	mourning
move	moved	moved	moving
mow	mowed	mown / mowed	mowing
muck	mucked	mucked	mucking
muddle	muddled	muddled	muddling
muffle	muffled	muffled	muffling
mug	mugged	mugged	mugging
mull	mulled	mulled	mulling
multiply	multiplied	multiplied	multiplying
mumble	mumbled	mumbled	mumbling
murder	murdered	murdered	murdering
murmur	murmured	murmured	murmuring
mutilate	mutilated	mutilated	mutilating
mutter	muttered	muttered	muttering
nab	nabbed	nabbed	nabbing
nag	nagged	nagged	nagging
nail	nailed	nailed	nailing
name	named	named	naming
narrate	narrated	narrated	narrating
nationalize	nationalized	nationalized	nationalizing
nauseate	nauseated	nauseated	nauseating
near	neared	neared	nearing
necessitate	necessitated	necessitated	necessitating
need	needed	needed	needing
neglect	neglected	neglected	neglecting
negotiate	negotiated	negotiated	negotiating
neigh	neighed	neighed	neighing
nest	nested	nested	nesting
net	netted	netted	netting
nickname	nicknamed	nicknamed	nicknaming
nip	nipped	nipped	nipping
nobble	nobbled	nobbled	nobbling
nod	nodded	nodded	nodding
nominate	nominated	nominated	nominating
nose-dive	nose-dived	nose-dived	nose-diving
note	noted	noted	noting
notice	noticed	noticed	noticing
notify	notified	notified	notifying
nourish	nourished	nourished	nourishing
nudge	nudged	nudged	nudging
nullify	nullified	nullified	nullifying
number	numbered	numbered	numbering
number	numbered	numbered	numbering
nurse	nursed	nursed	nursing
nurture	nurtured	nurtured	nurturing
obey	obeyed	obeyed	obeying
object	objected	objected	objecting
oblige	obliged	obliged	obliging
observe	observed	observed	observing
obsess	obsessed	obsessed	obsessing
obstruct	obstructed	obstructed	obstructing
obtain	obtained	obtained	obtaining
obtrude	obtruded	obtruded	obtruding
occupy	occupied	occupied	occupying
occur	occurred	occurred	occurring
offend	offended	offended	offending
offer	offered	offered	offering
ogle	ogled	ogled	ogling
oil	oiled	oiled	oiling
omit	omitted	omitted	omitting
open	opened	opened	opening
operate	operated	operated	operating
opine	opined	opined	opining
oppose	opposed	opposed	opposing
oppress	oppressed	oppressed	oppressing
opt	opted	opted	opting
order	ordered	ordered	ordering
organize	organized	organized	organizing
originate	originated	originated	originating
ornament	ornamented	ornamented	ornamenting
oscillate	oscillated	oscillated	oscillating
ossify	ossified	ossified	ossifying
oust	ousted	ousted	ousting
out run	out ran	out run	out running
out sell	out sold	out sold	outselling
out shine	out shone	out shone	out shining
outbid	outbid	outbid	outbidding
outgo	outgrew	outgrown	outgrowing
outvote	outvoted	outvoted	outvoting
outwit	outwitted	outwitted	outwitting
over bear	over bore	over bome	overbearing
over come	overcame	overcome	overcoming
over haul	over hauled	over hauled	over hauling
over lay	overlaid	overlaid	overlaying
over look	over looked	over looked	over looking
over run	over ran	over run	over running
over see	over saw	over seen	over seeing
over shoo	over slept	over slept	over sleeping
over turn	over turned	over turned	over turning
over whelm	over whelmed	over whelmed	over whelming
overcast	overcast	overcast	overcasting
overcome	overcomed	overcomed	overcoming
overdo	overdid	overdone	overdoing
overdrew	overdrew	overdrawn	overdrawing
overflow	overflowed	overflowed	overflowing
overhang	overhung	overhung	overhunging
overhaul	overhauled	overhauled	overhauling
overhear	overheared	overheared	overhearing
overlap	overlapped	overlapped	overlapping
overlook	overlooked	overlooked	overlooking
overpay	overpaid	overpaid	over paying
override	overrode	overridden	over riding
oversee	oversaw	overseen	overseeing
overtake	overtaked	overtaked	overtaking
overthrow	overthrew	overthrown	overthrowing
overwhelm	overwhelmed	overwhelmed	overwhelming
owe	owed	owed	owing
own	owned	owned	owning
pace	paced	paced	pacing
pacify	pacified	pacified	pacifying
pack	packed	packed	packing
paddle	paddled	paddled	paddling
page	paged	paged	paging
pain	pained	pained	paining
paint	painted	painted	painting
palliate	palliated	palliated	palliating
palpitate	palpitated	palpitated	palpitating
palsy	palsied	palsied	palsying
pancake	pancaked	pancaked	pancaking
panic	panicked	panicked	panicking
pant	panted	panted	panting
parade	paraded	paraded	parading
paralyse	paralysed	paralysed	paralysing
parch	parched	parched	parching
pardon	pardoned	pardoned	pardoning
pare	pared	pared	paring
park	parked	parked	parking
parole	paroled	paroled	paroling
parry	parried	parried	parrying
parse	parsed	parsed	parsing
part	parted	parted	parting
partake	partook	partaken	partaking
participate	participated	participated	participating
pass	passed	passed	passing
passage	passaged	passaged	passaging
paste	pasted	pasted	pasting
pasteurize	pasteurized	pasteurized	pasteurizing
pat	patted	patted	patting
patrol	patrolled	patrolled	patrolling
patronize	patronized	patronized	patronizing
pause	paused	paused	pausing
pave	paved	paved	paving
pawn	pawned	pawned	pawning
pay	paid	paid	paying
peal	pealed	pealed	pealing
peck	pecked	pecked	pecking
peculate	peculated	peculated	peculating
peel	peeled	peeled	peeling
peep	peeped	peeped	peeping
peer	peered	peered	peering
peg	pegged	pegged	pegging
pelt	pelted	pelted	pelting
pen	penned	penned	penning
pencil	pencilled	pencilled	pencilling
penetrate	penetrated	penetrated	penetrating
perceive	perceived	perceived	perceiving
perch	perched	perched	perching
percolate	percolated	percolated	percolating
perfect	perfected	perfected	perfecting
perform	performed	performed	performing
perfume	perfumed	perfumed	perfuming
peril	periled	periled	periling
perish	perished	perished	perishing
perjure	perjured	perjured	perjuring
permeate	permeated	permeated	permeating
permit	permitted	permitted	permitting
perpetrate	perpetrated	perpetrated	perpetrating
perpetuate	perpetuated	perpetuated	perpetuating
perplex	perplexed	perplexed	perplexing
persecute	persecuted	persecuted	persecuting
persevere	persevered	persevered	persevering
persist	persisted	persisted	persisting
personify	personified	personified	personifying
persovere	persovered	persovered	persovering
perspire	perspired	perspired	perspiring
persuade	persuaded	persuaded	persuading
pertain	pertained	pertained	pertaining
perturb	perturbed	perturbed	perturbing
peruse	perused	perused	perusing
pervade	pervaded	pervaded	pervading
pervert	perverted	perverted	perverting
pester	pestered	pestered	pestering
pestle	pestled	pestled	pestling
pet	petted	petted	petting
peter	petered	petered	petering
petrify	petrified	petrified	petrifying
philander	philandered	philandered	philandering
photocopy	photocopied	photocopied	photocopying
photograph	photographed	photographed	photographing
photostat	photostated	photostated	photostating
pick	picked	picked	picking
picnic	picnicked	picnicked	picnicking
picture	pictured	pictured	picturing
piece	pieced	pieced	piecing
pierce	pierced	pierced	piercing
pile	piled	piled	piling
pilfer	pilfered	pilfered	pilfering
pillage	pillaged	pillaged	pillaging
pin	pinned	pinned	pinning
pinch	pinched	pinched	pinching
pine	pined	pined	pining
pipe	piped	piped	piping
pirate	pirated	pirated	pirating
piss	pissed	pissed	pissing
pistol	pistoled	pistoled	pistoling
pitch	pitched	pitched	pitching
pity	pitied	pitied	pitying
placate	placated	placated	placating
place	placed	placed	placing
plagiarize	plagiarized	plagiarized	plagiarizing
plait	plaited	plaited	plaiting
plan	planned	planned	planning
plank	planked	planked	planking
plant	planted	planted	planting
plash	plashed	plashed	plashing
plaster	plastered	plastered	plastering
play	played	played	playing
plead	pleaded	pleaded	pleading
please	pleased	pleased	pleasing
pledge	pledged	pledged	pledging
plight	plighted	plighted	plighting
plod	plodded	plodded	plodding
plot	plotted	plotted	plotting
plough	ploughed	ploughed	ploughing
pluck	plucked	plucked	plucking
plug	plugged	plugged	plugging
plume	plumed	plumed	pluming
plunder	plundered	plundered	plundering
plunge	plunged	plunged	plunging
ply	plied	plied	plying
poach	poached	poached	poaching
point	pointed	pointed	pointing
poise	poised	poised	poising
poison	poisoned	poisoned	poisoning
poke	poked	poked	poking
polish	polished	polished	polishing
poll	polled	polled	polling
pollute	polluted	polluted	polluting
ponder	pondered	pondered	pondering
pool	pooled	pooled	pooling
pop	popped	popped	popping
populate	populated	populated	populating
pore	pored	pored	poring
portend	portended	portended	portending
portray	portrayed	portrayed	portraying
pose	posed	posed	posing
possess	possessed	possessed	possessing
post	posted	posted	posting
postpone	postponed	postponed	postponing
postulate	postulated	postulated	postulating
potter	pottered	pottered	pottering
pouch	pouched	pouched	pouching
pour	poured	poured	pouring
pout	pouted	pouted	pouting
powder	powdered	powdered	powdering
practice	practiced	practiced	practicing
practise	practised	practised	practising
praise	praised	praised	praising
prate	prated	prated	prating
prattle	prattled	prattled	prattling
pray	prayed	prayed	praying
preach	preached	preached	preaching
precede	preceded	preceded	preceding
precipitate	precipitated	precipitated	precipitating
preclude	precluded	precluded	precluding
predicate	predicated	predicated	predicating
predict	predicted	predicted	predicting
predominate	predominated	predominated	predominating
preempt	preempted	preempted	preempting
preface	prefaced	prefaced	prefacing
prefer	preferred	preferred	preferring
prejudice	prejudiced	prejudiced	prejudicing
prelude	preluded	preluded	preluding
premeditate	premeditated	premeditated	premeditating
premise	premised	premised	premising
preoccupy	preoccupied	preoccupied	preoccupying
prepare	prepared	prepared	preparing
preponderate	preponderated	preponderated	preponderating
prescribe	prescribed	prescribed	prescribing
present	presented	presented	presenting
preserve	preserved	preserved	preserving
preside	presided	presided	presiding
press	pressed	pressed	pressing
pressurize	pressurized	pressurized	pressurizing
presume	presumed	presumed	presuming
presuppose	presupposed	presupposed	presupposing
pretend	pretended	pretended	pretending
prevail	prevailed	prevailed	prevailing
prevaricate	prevaricated	prevaricated	prevaricating
prevent	prevented	prevented	preventing
prey	preyed	preyed	preying
prick	pricked	pricked	pricking
prickle	prickled	prickled	prickling
prig	prigged	prigged	prigging
print	printed	printed	printing
privilege	privileged	privileged	privileging
prize	prized	prized	prizing
probe	probed	probed	probing
proceed	proceeded	proceeded	proceeding
procession	processioned	processioned	processioning
proclaim	proclaimed	proclaimed	proclaiming
procreate	procreated	procreated	procreating
procure	procured	procured	procuring
prod	prodded	prodded	prodding
produce	produced	produced	producing
profane	profaned	profaned	profaning
profess	professed	professed	professing
proffer	proffered	proffered	proffering
profile	profiled	profiled	profiling
profit	profited	profited	profiting
prognosticate	prognosticated	prognosticated	prognosticating
progress	progressed	progressed	progressing
prohibit	prohibited	prohibited	prohibiting
project	projected	projected	projecting
proliferate	proliferated	proliferated	proliferating
prolong	prolonged	prolonged	prolonging
promenade	promenaded	promenaded	promenading
promise	promised	promised	promising
promote	promoted	promoted	promoting
promulgate	promulgated	promulgated	promulgating
promulge	promulged	promulged	promulging
pronounce	pronounced	pronounced	pronouncing
prop	propped	propped	propping
propel	propelled	propelled	propelling
prophesy	prophesied	prophesied	prophesying
propitiate	propitiated	propitiated	propitiating
propogate	propogated	propogated	propogating
proportion	proportioned	proportioned	proportioning
proportionate	proportionated	proportionated	proportionating
propose	proposed	proposed	proposing
propound	propounded	propounded	propounding
prorogue	prorogued	prorogued	proroguing
proscribe	proscribed	proscribed	proscribing
prosecute	prosecuted	prosecuted	prosecuting
proselyte	proselyted	proselyted	proselyting
prosper	prospered	prospered	prospering
prostitute	prostituted	prostituted	prostituting
prostrate	prostrated	prostrated	prostrating
protect	protected	protected	protecting
protest	protested	protested	protesting
protract	protracted	protracted	protracting
protrude	protruded	protruded	protruding
prove	proved	proved	proving
provide	provided	provided	providing
provoke	provoked	provoked	provoking
prowl	prowled	prowled	prowling
prune	pruned	pruned	pruning
publish	published	published	publishing
puddle	puddled	puddled	puddling
puff	puffed	puffed	puffing
pug	pugged	pugged	pugging
pull	pulled	pulled	pulling
pullulate	pullulated	pullulated	pullulating
pulmp	pulmped	pulmped	pulmping
pulp	pulped	pulped	pulping
pulsate	pulsated	pulsated	pulsating
pulse	pulsed	pulsed	pulsing
pulverize	pulverized	pulverized	pulverizing
pump	pumped	pumped	pumping
punch	punched	punched	punching
puncture	punctured	punctured	puncturing
punish	punished	punished	punishing
punt	punted	punted	punting
purchase	purchased	purchased	purchasing
purge	purged	purged	purging
purify	purified	purified	purifying
purl	purled	purled	purling
purloin	purloined	purloined	purloining
purport	purported	purported	purporting
purpose	purposed	purposed	purposing
pursue	pursued	pursued	pursuing
purvey	purveyed	purveyed	purveying
push	pushed	pushed	pushing
put	put	put	putting
putrefy	putrefied	putrefied	putrefying
puzzle	puzzled	puzzled	puzzling
quack	quacked	quacked	quacking
quaff	quaffed	quaffed	quaffing
quail	quailed	quailed	quailing
quake	quaked	quaked	quaking
qualify	qualified	qualified	qualifying
quarrel	quarrelled	quarrelled	quarrelling
quash	quashed	quashed	quashing
quaver	quavered	quavered	quavering
quell	quelled	quelled	quelling
quench	quenched	quenched	quenching
quest	quested	quested	questing
question	questioned	questioned	questioning
queue	queued	queued	queuing
quicken	quickened	quickened	quickening
quiddle	quiddled	quiddled	quiddling
quiet	quieted	quieted	quieting
quieten	quietened	quietened	quietening
quilt	quilted	quilted	quilting
quip	quipped	quipped	quipping
quit	quit / quitted	quit / quitted	quiting
quiver	quivered	quivered	quivering
quote	quoted	quoted	quoting
race	raced	raced	racing
raddle	raddled	raddled	raddling
radio	radioed	radioed	radioing
rag	ragged	ragged	ragging
rage	raged	raged	raging
raid	raided	raided	raiding
rail	railed	railed	railing
rain	rained	rained	raining
raise	raised	raised	raising
rake	raked	raked	raking
rally	rallied	rallied	rallying
ramify	ramified	ramified	ramifying
ramp	ramped	ramped	ramping
range	ranged	ranged	ranging
ransom	ransomed	ransomed	ransoming
rant	ranted	ranted	ranting
rap	rapped	rapped	rapping
rape	raped	raped	raping
rarefy	rarefied	rarefied	rarefying
rasp	rasped	rasped	rasping
rate	rated	rated	rating
ratify	ratified	ratified	ratifying
rattle	rattled	rattled	rattling
ravage	ravaged	ravaged	ravaging
ravel	raveled	raveled	raveling
ravish	ravished	ravished	ravishing
reach	reached	reached	reaching
react	reacted	reacted	reacting
read	read	read	reading
realize	realized	realized	realizing
reap	reaped	reaped	reaping
rear	reared	reared	rearing
reason	reasoned	reasoned	reasoning
reassemble	reassembled	reassembled	reassembling
rebel	rebelled	rebelled	rebelling
rebuild	rebuilt	rebuilt	rebuilding
rebuke	rebuked	rebuked	rebuking
recall	recalled	recalled	recalling
recant	recanted	recanted	recanting
receive	received	received	receiving
recite	recited	recited	reciting
reckon	reckoned	reckoned	reckoning
reclaim	reclaimed	reclaimed	reclaiming
recognize	recognized	recognized	recognizing
recoil	recoiled	recoiled	recoiling
recollect	recollected	recollected	recollecting
recommend	recommended	recommended	recommending
reconcile	reconciled	reconciled	reconciling
reconnoiter	reconnoitered	reconnoitered	reconnoitering
record	recorded	recorded	recording
recount	recounted	recounted	recounting
recoup	recouped	recouped	recouping
recover	recovered	recovered	recovering
recruit	recruited	recruited	recruiting
rectify	rectified	rectified	rectifying
recur	recurred	recurred	recurring
redden	reddened	reddened	reddening
redeem	redeemed	redeemed	redeeming
redeploy	redeployed	redeployed	redeploying
redress	redressed	redressed	redressing
reduce	reduced	reduced	reducing
reek	reeked	reeked	reeking
reel	reeled	reeled	reeling
refer	referred	referred	referring
refill	refilled	refilled	refilling
refine	refined	refined	refining
reflect	reflected	reflected	reflecting
reform	reformed	reformed	reforming
refract	refracted	refracted	refracting
refrain	refrained	refrained	refraining
refresh	refreshed	refreshed	refreshing
refuel	refuelled	refuelled	refuelling
refund	refunded	refunded	refunding
refuse	refused	refused	refusing
regain	regained	regained	regaining
regard	regarded	regarded	regarding
register	registered	registered	registering
regress	regressed	regressed	regressing
regret	regretted	regretted	regretting
regulate	regulated	regulated	regulating
rehearse	rehearsed	rehearsed	rehearsing
reign	reigned	reigned	reigning
reject	rejected	rejected	rejecting
rejoice	rejoiced	rejoiced	rejoicing
rejoin	rejoined	rejoined	rejoining
relate	related	related	relating
relax	relaxed	relaxed	relaxing
relay	relayed	relayed	relaying
release	released	released	releasing
relent	relented	relented	relenting
relieve	relieved	relieved	relieving
relinquish	relinquished	relinquished	relinquishing
relish	relished	relished	relishing
rely	relied	relied	relying
remain	remained	remained	remaining
remand	remanded	remanded	remanding
remark	remarked	remarked	remarking
remedy	remedied	remedied	remedying
remember	remembered	remembered	remembering
remind	reminded	reminded	reminding
remit	remitted	remitted	remitting
remove	removed	removed	removing
rend	rent	rent	rending
render	rendered	rendered	rendering
renew	renewed	renewed	renewing
renounce	renounced	renounced	renouncing
rent	rented	rented	renting
reopen	reopened	reopened	reopening
repair	repaired	repaired	repairing
repay	repaid	repaid	repaying
repeal	repealed	repealed	repealing
repeat	repeated	repeated	repeating
repel	repelled	repelled	repelling
repent	repented	repented	repenting
replace	replaced	replaced	replacing
replay	replied	replied	replying
reply	replied	replied	replying
report	reported	reported	reporting
reprehend	reprehended	reprehended	reprehending
represent	represented	represented	representing
repress	repressed	repressed	repressing
reprimand	reprimanded	reprimanded	reprimanding
reprint	reprinted	reprinted	reprinting
reproach	reproached	reproached	reproaching
reproduce	reproduced	reproduced	reproducing
request	requested	requested	requesting
require	required	required	requiring
requite	requited	requited	requiting
rescind	rescinded	rescinded	rescinding
rescue	rescued	rescued	rescuing
research	researched	researched	researching
resemble	resembled	resembled	resembling
resent	resented	resented	resenting
reserve	reserved	reserved	reserving
resign	resigned	resigned	resigning
resist	resisted	resisted	resisting
resolve	resolved	resolved	resolving
resort	resorted	resorted	resorting
resound	resounded	resounded	resounding
respect	respected	respected	respecting
respond	responded	responded	responding
rest	rested	rested	resting
restore	restored	restored	restoring
restrain	restrained	restrained	restraining
restrict	restricted	restricted	restricting
result	resulted	resulted	resulting
resume	resumed	resumed	resuming
retail	retailed	retailed	retailing
retain	retained	retained	retaining
retake	retook	retaken	retaking
retaliate	retaliated	retaliated	retaliating
retard	retarded	retarded	retarding
retch	retched	retched	retching
rethink	rethought	rethought	rethinking
retire	retired	retired	retiring
retort	retorted	retorted	retorting
retract	retracted	retracted	retracting
retread	retreaded	retreaded	retreading
retreat	retreated	retreated	retreating
retrogress	retrogressed	retrogressed	retrogressing
return	returned	returned	returning
reveal	revealed	revealed	revealing
revenge	revenged	revenged	revenging
revert	reverted	reverted	reverting
review	reviewed	reviewed	reviewing
revile	reviled	reviled	reviling
revise	revised	revised	revising
revivify	revivified	revivified	revivifying
revoke	revoked	revoked	revoking
revolt	revolted	revolted	revolting
revolve	revolved	revolved	revolving
reward	rewarded	rewarded	rewarding
rewind	rewound	rewound	rewinding
rewrite	rewrote	rewritten	rewriting
rhyme	rhymed	rhymed	rhyming
rid	rid / ridded	rid / ridded	ridding
ride	rode	ridden	riding
ridicule	ridiculed	ridiculed	ridiculing
rif	riffed	riffed	riffing
right	righted	righted	righting
ring	rang	rung	ringing
rinse	rinsed	rinsed	rinsing
ripen	ripened	ripened	ripening
rise	rose	risen	rising
risk	risked	risked	risking
rival	rivalled	rivalled	rivalling
rivet	riveted	riveted	riveting
roam	roamed	roamed	roaming
roar	roared	roared	roaring
roast	roasted	roasted	roasting
rob	robbed	robbed	robbing
rock	rocked	rocked	rocking
roil	roiled	roiled	roiling
roister	roistered	roistered	roistering
roll	rolled	rolled	rolling
rollick	rollicked	rollicked	rollicking
romanticize	romanticized	romanticized	romanticizing
roost	roosted	roosted	roosting
root	rooted	rooted	rooting
roquet	roqueted	roqueted	roqueting
rot	rotted	rotted	rotting
rotate	rotated	rotated	rotating
rout	routed	routed	routing
rove	roved	roved	roving
row	rowed	rowed	rowing
rub	rubbed	rubbed	rubbing
ruffle	ruffled	ruffled	ruffling
ruin	ruined	ruined	ruining
rule	ruled	ruled	ruling
ruminate	ruminated	ruminated	ruminating
rumple	rumpled	rumpled	rumpling
run	ran	run	running
rush	rushed	rushed	rushing
rush	rushed	rushed	rushing
rust	rusted	rusted	rusting
rustle	rustled	rustled	rustling
sack	sacked	sacked	sacking
sacrifice	sacrificed	sacrificed	sacrificing
sadden	saddened	saddened	saddening
saddle	saddled	saddled	saddling
sail	sailed	sailed	sailing
sain	sained	sained	saining
salt	salted	salted	salting
salute	saluted	saluted	saluting
sanctify	sanctified	sanctified	sanctifying
sanction	sanctioned	sanctioned	sanctioning
sandwich	sandwiched	sandwiched	sandwiching
sap	sapped	sapped	sapping
satiate	satiated	satiated	satiating
satirize	satirized	satirized	satirizing
satisfy	satisfied	satisfied	satisfying
saunter	sauntered	sauntered	sauntering
save	saved	saved	saving
savvy	savvied	savvied	savvying
saw	sawed	sawed	sawing
say	said	said	saying
scabbard	scabbarded	scabbarded	scabbarding
scald	scalded	scalded	scalding
scamp	scamped	scamped	scamping
scamper	scampered	scampered	scampering
scan	scanned	scanned	scanning
scare	scared	scared	scaring
scarify	scarified	scarified	scarifying
scatter	scattered	scattered	scattering
scissor	scissored	scissored	scissoring
scoff	scoffed	scoffed	scoffing
scold	scolded	scolded	scolding
scoop	scooped	scooped	scooping
scoot	scooted	scooted	scooting
scorch	scorched	scorched	scorching
score	scored	scored	scoring
scorify	scorified	scorified	scorifying
scorn	scorned	scorned	scorning
scotch	scotched	scotched	scotching
scour	scoured	scoured	scouring
scourge	scourged	scourged	scourging
scout	scouted	scouted	scouting
scowl	scowled	scowled	scowling
scrabble	scrabbled	scrabbled	scrabbling
scrag	scragged	scragged	scragging
scrap	scrapped	scrapped	scrapping
scrape	scraped	scraped	scraping
scratch	scratched	scratched	scratching
scrawl	scrawled	scrawled	scrawling
screak	screaked	screaked	screaking
scream	screamed	screamed	screaming
screech	screeched	screeched	screeching
screen	screened	screened	screening
screw	screwed	screwed	screwing
scribble	scribbled	scribbled	scribbling
scrounge	scrounged	scrounged	scrounging
scrub	scrubbed	scrubbed	scrubbing
scrunch	scrunched	scrunched	scrunching
scruple	scrupled	scrupled	scrupling
scud	scudded	scudded	scudding
scuff	scuffed	scuffed	scuffing
scuffle	scuffled	scuffled	scuffling
scupper	scuppered	scuppered	scuppering
scurry	scurried	scurried	scurrying
seal	sealed	sealed	sealing
sear	seared	seared	searing
search	searched	searched	searching
seat	seated	seated	seating
secure	secured	secured	securing
seduce	seduced	seduced	seducing
see	saw	seen	seeing
seek	sought	sought	seeking
seel	seeled	seeled	seeling
seem	seemed	seemed	seeming
seep	seeped	seeped	seeping
seethe	seethed	seethed	seething
segregate	segregated	segregated	segregating
seize	seized	seized	seizing
select	selected	selected	selecting
sell	sold	sold	selling
send	sent	sent	sending
sentence	sentenced	sentenced	sentencing
sentimentalize	sentimentalized	sentimentalized	sentimentalizing
sentinel	sentineled	sentineled	sentineling
separate	separated	separated	separating
sepulcher	sepulchered	sepulchered	sepulchering
sequester	sequestered	sequestered	sequestering
serve	served	served	serving
set	set	set	setting
settle	settled	settled	settling
sever	severed	severed	severing
sew	sewed	sewed	sewing
shade	shaded	shaded	shading
shake	shook	shaken	shaking
sham	shammed	shammed	shamming
shampoo	shampooed	shampooed	shampooing
shanghai	shanghaied	shanghaied	shanghaiing
shape	shaped	shaped	shaping
share	shared	shared	sharing
shark	sharked	sharked	sharking
sharpen	sharpened	sharpened	sharpening
shatter	shattered	shattered	shattering
shave	shaved	shaved	shaving
shear	shorn	shorn	shoing
sheath	sheathed	sheathed	sheathing
shed	shed	shed	shedding
sheer	sheered	sheered	sheering
shell	shelled	shelled	shelling
shelter	sheltered	sheltered	sheltering
shield	shielded	shielded	shielding
shift	shifted	shifted	shifting
shimmer	shimmered	shimmered	shimmering
shine	shone / shined	shone / shined	shining
shirk	shirked	shirked	shirking
shiver	shivered	shivered	shivering
shock	shocked	shocked	shocking
shoe	shod	shod	shoeing
shoot	shot	shot	shooting
shop	shopped	shopped	shopping
shout	shouted	shouted	shouting
show	showed	shown / showed	showing
shower	showered	showered	showering
shriek	shrieked	shrieked	shrieking
shrink	shrank	shrunk	shrinking
shrive	shrove	shriven	shriving
shrug	shrugged	shrugged	shrugging
shudder	shuddered	shuddered	shuddering
shuffle	shuffled	shuffled	shuffling
shunt	shunted	shunted	shunting
shut	shut	shut	shutting
sicken	sickened	sickened	sickening
sift	sifted	sifted	sifting
sigh	sighed	sighed	sighing
sight	sighted	sighted	sighting
sign	signed	signed	signing
signal	signalled	signalled	signalling
silence	silenced	silenced	silencing
silt	silted	silted	silting
silver	silvered	silvered	silvering
simmer	simmered	simmered	simmering
simper	simpered	simpered	simpering
simplify	simplified	simplified	simplifying
sin	sinned	sinned	sinning
sinew	sinewed	sinewed	sinewing
sing	sang	sung	singing
sink	sank	sunk	sinking
sip	sipped	sipped	sipping
siphon	siphoned	siphoned	siphoning
sit	sat	sat	sitting
situate	situated	situated	situating
sketch	sketched	sketched	sketching
skim	skimmed	skimmed	skimming
skin	skinned	skinned	skinning
skip	skipped	skipped	skipping
skive	skived	skived	skiving
skulk	skulked	skulked	skulking
slacken	slackened	slackened	slackening
slake	slaked	slaked	slaking
slam	slammed	slammed	slamming
slant	slanted	slanted	slanting
slash	slashed	slashed	slashing
slave	slaved	slaved	slaving
slaver	slavered	slavered	slavering
slay	slew	slain	slaying
sleek	sleeked	sleeked	sleeking
sleep	slept	slept	sleeping
sleigh	sleighed	sleighed	sleighing
slice	sliced	sliced	slicing
slide	slid	slid	sliding
slight	slighted	slighted	slighting
slip	slipped	slipped	slipping
slit	slit	slit	slitting
slither	slithered	slithered	slithering
slobber	slobbered	slobbered	slobbering
slop	slopped	slopped	slopping
slope	sloped	sloped	sloping
slouch	slouched	slouched	slouching
slough	sloughed	sloughed	sloughing
slow	slowed	slowed	slowing
slumber	slumbered	slumbered	slumbering
slur	slurred	slurred	slurring
slurp	slurped	slurped	slurping
smack	smacked	smacked	smacking
smash	smashed	smashed	smashing
smear	smeared	smeared	smearing
smell	smelled / smelt	smelled / smelt	smelling
smile	smiled	smiled	smiling
smirch	smirched	smirched	smirching
smirk	smirked	smirked	smirking
smite	smote	smitten	smiting
smoke	smoked	smoked	smoking
smooth	smoothed	smoothed	smoothing
smother	smothered	smothered	smothering
snarl	snarled	snarled	snarling
snatch	snatched	snatched	snatching
sneak	sneaked	sneaked	sneaking
sneer	sneered	sneered	sneering
sneeze	sneezed	sneezed	sneezing
sniff	sniffed	sniffed	sniffing
snook	snooked	snooked	snooking
snoop	snooped	snooped	snooping
snore	snored	snored	snoring
snort	snorted	snorted	snorting
snow	snowed	snowed	snowing
snuff	snuffed	snuffed	snuffing
snuffle	snuffled	snuffled	snuffling
soak	soaked	soaked	soaking
soar	soared	soared	soaring
sob	sobbed	sobbed	sobbing
sob	sobbed	sobbed	sobbing
sober	sobered	sobered	sobering
sock	socked	socked	socking
soften	softened	softened	softening
soil	soiled	soiled	soiling
solder	soldered	soldered	soldering
solemnize	solemnized	solemnized	solemnizing
solicit	solicited	solicited	soliciting
solve	solved	solved	solving
soothe	soothed	soothed	soothing
sort	sorted	sorted	sorting
sough	soughed	soughed	soughing
sound	sounded	sounded	sounding
sow	sowed	sowed / sown	sowing
space	spaced	spaced	spacing
spare	spared	spared	sparing
spark	sparked	sparked	sparking
sparkle	sparkled	sparkled	sparkling
spatter	spattered	spattered	spattering
speak	spoke	spoken	speaking
spear	speared	speared	spearing
specify	specified	specified	specifying
speed	speeded / sped	speeded / sped	speeding
spell	spelled / spelt	spelled / spelt	spelling
spend	spent	spent	spending
spew	spewed	spewed	spewing
spill	spilled / spilt	spilled / spilt	spilling
spin	span	spun	spining
spirit	spirited	spirited	spiriting
spit	spat / spit	spat / spit	spitting
splash	splashed	splashed	splashing
split	split	split	splitting
splutter	spluttered	spluttered	spluttering
spoil	spoiled / spoilt	spoiled / spoilt	spoiling
sponsor	sponsored	sponsored	sponsoring
spoon	spooned	spooned	spooning
sport	sported	sported	sporting
spout	spouted	spouted	spouting
spray	sprayed	sprayed	spraying
spread	spreaded	spreaded	spreading
spring	sprang	sprung	springing
sprinke	sprinked	sprinked	sprinking
sprinkle	sprinkled	sprinkled	sprinkling
sprout	sprouted	sprouted	sprouting
spurn	spurned	spurned	spurning
sputter	sputtered	sputtered	sputtering
spy	spied	spied	spying
squabble	squabbled	squabbled	squabbling
squall	squalled	squalled	squalling
squander	squandered	squandered	squandering
squash	squashed	squashed	squashing
squeal	squealed	squealed	squealing
squeeze	squeezed	squeezed	squeezing
squint	squinted	squinted	squinting
squirm	squirmed	squirmed	squirming
squirt	squirted	squirted	squirting
squish	squished	squished	squishing
stab	stabbed	stabbed	stabbing
stack	stacked	stacked	stacking
stage	staged	staged	staging
stagger	staggered	staggered	staggering
stagnate	stagnated	stagnated	stagnating
stain	stained	stained	staining
stalk	stalked	stalked	stalking
stall	stalled	stalled	stalling
stammer	stammered	stammered	stammering
stamp	stamped	stamped	stamping
stand	stood	stood	standing
standardize	standardized	standardized	standardizing
stare	stared	stared	staring
start	started	started	starting
startle	startled	startled	startling
starve	starved	starved	starving
state	stated	stated	stating
station	stationed	stationed	stationing
stay	stayed	stayed	staying
steal	stole	stolen	stealing
steep	steeped	steeped	steeping
steer	steered	steered	steering
stencil	stenciled	stenciled	stenciling
step	stepped	stepped	stepping
stew	stewed	stewed	stewing
stick	stuck	stuck	sticking
stiffen	stiffened	stiffened	stiffening
stimulate	stimulated	stimulated	stimulating
sting	stung	stung	stinging
stink	stuck	stuck	sticking
stint	stinted	stinted	stinting
stipulate	stipulated	stipulated	stipulating
stir	stirred	stirred	stirring
stitch	stitched	stitched	stitching
stock	stocked	stocked	stocking
stoop	stooped	stooped	stooping
stop	stopped	stopped	stopping
store	stored	stored	storing
storm	stormed	stormed	storming
straighten	straightened	straightened	straightening
strain	strained	strained	straining
straiten	straitened	straitened	straitening
strand	stranded	stranded	stranding
strangle	strangled	strangled	strangling
stray	strayed	strayed	straying
streak	streaked	streaked	streaking
streek	streeked	streeked	streeking
strengthen	strengthened	strengthened	strengthening
stress	stressed	stressed	stressing
stretch	stretched	stretched	stretching
strew	strow	strewn	strewing
stride	strode	stridden	striding
strike	struck	struck	striking
string	strung	strung	stringing
strip	stripped	stripped	stripping
stripe	striped	striped	striping
strive	strove	striven	striving
stroke	stroked	stroked	stroking
stroll	strolled	strolled	strolling
struggle	struggled	struggled	struggling
strut	strutted	strutted	strutting
study	studied	studied	studying
stuff	stuffed	stuffed	stuffing
stun	stunned	stunned	stunning
subject	subjected	subjected	subjecting
submit	submitted	submitted	submitting
suborn	suborned	suborned	suborning
subpoena	subpoenaed	subpoenaed	subpoenaing
subscribe	subscribed	subscribed	subscribing
subside	subsided	subsided	subsiding
subsist	subsisted	subsisted	subsisting
substitue	substituted	substituted	substituting
substitute	substituted	substituted	substituting
subtract	subtracted	subtracted	subtracting
succeed	succeeded	succeeded	succeeding
succumb	succumbed	succumbed	succumbing
suck	sucked	sucked	sucking
suckle	suckled	suckled	suckling
suffer	suffered	suffered	suffering
suffocate	suffocated	suffocated	suffocating
suggest	suggested	suggested	suggesting
suit	suited	suited	suiting
sulk	sulked	sulked	sulking
sully	sullied	sullied	sullying
summarise	summarised	summarised	summarising
summarize	summarized	summarized	summarizing
summon	summoned	summoned	summoning
sup	supped	supped	supping
supervise	supervised	supervised	supervising
supplant	supplanted	supplanted	supplanting
supply	supplied	supplied	supplying
support	supported	supported	supporting
suppose	supposed	supposed	supposing
suppress	suppressed	suppressed	suppressing
surfeit	surfeited	surfeited	surfeiting
surmise	surmised	surmised	surmising
surpass	surpassed	surpassed	surpassing
surprise	surprised	surprised	surprising
surrender	surrendered	surrendered	surrendering
surround	surrounded	surrounded	surrounding
survey	surveyed	surveyed	surveying
suspect	suspected	suspected	suspecting
suspend	suspended	suspended	suspending
sustain	sustained	sustained	sustaining
swaddle	swaddled	swaddled	swaddling
swagger	swaggered	swaggered	swaggering
swallow	swallowed	swallowed	swallowing
swarm	swarmed	swarmed	swarming
sway	swayed	swayed	swaying
swear	swore	sworn	swearing
sweat	sweated	sweated	sweating
sweep	swept	swept	sweeping
sweeten	sweetened	sweetened	sweetening
swell	swelled	swelled / swellen	swelling
swelter	sweltered	sweltered	sweltering
swill	swilled	swilled	swilling
swim	swam	sum	swimming
swing	swung	swung	swinging
swirl	swirled	swirled	swirling
swish	swished	swished	swishing
switch	switched	switched	switching
swoon	swooned	swooned	swooning
swoop	swooped	swooped	swooping
swot	swotted	swotted	swotting
symbolize	symbolized	symbolized	symbolizing
sympathize	sympathized	sympathized	sympathizing
systematize	systematized	systematized	systematizing
taboo	tabooed	tabooed	tabooing
tabulate	tabulated	tabulated	tabulating
tack	tacked	tacked	tacking
tackle	tackled	tackled	tackling
taint	tainted	tainted	tainting
take	took	taken	taking
talk	talked	talked	talking
tame	tamed	tamed	taming
tamper	tampered	tampered	tampering
tank	tanked	tanked	tanking
tantalize	tantalized	tantalized	tantalizing
tap	tapped	tapped	tapping
target	targeted	targeted	targeting
tarnish	tarnished	tarnished	tarnishing
tarry	tarried	tarried	tarrying
taste	tasted	tasted	tasting
tattle	tattled	tattled	tattling
tattoo	tattooed	tattooed	tattooing
tax	taxed	taxed	taxing
taxi	taxied	taxied	taxiing
teach	taught	taught	teaching
tear	tore	torn	tearing
tease	teased	teased	teasing
teem	teemed	teemed	teeming
telegraph	telegraphed	telegraphed	telegraphing
telephone	telephoned	telephoned	telephoning
televise	televised	televised	televising
tell	told	told	telling
temper	tempered	tempered	tempering
tempt	tempted	tempted	tempting
tend	tended	tended	tending
tender	tendered	tendered	tendering
term	termed	termed	terming
terminate	terminated	terminated	terminating
terrify	terrified	terrified	terrifying
test	tested	tested	testing
tether	tethered	tethered	tethering
thank	thanked	thanked	thanking
thaw	thawed	thawed	thawing
thieve	thieved	thieved	thieving
think	thought	thought	thinking
thrash	thrashed	thrashed	thrashing
thread	threaded	threaded	threading
threat	threated	threated	threating
threaten	threatened	threatened	threatening
thresh	threshed	threshed	threshing
thrill	thrilled	thrilled	thrilling
thrive	throve / thrived	thriven / thrived	thriving
throb	throbbed	throbbed	throbbing
throttle	throttled	throttled	throttling
throw	threw	thrown	throwing
thrust	thrusted	thrusted	thrusting
thump	thumped	thumped	thumping
thunder	thundered	thundered	thundering
thwack	thwacked	thwacked	thwacking
thwart	thwarted	thwarted	thwarting
tick	ticked	ticked	ticking
tickle	tickled	tickled	tickling
tidy	tidied	tidied	tidying
tie	tied	tied	tying
tighten	tightened	tightened	tightening
till	tilled	tilled	tilling
tilt	tilted	tilted	tilting
tire	tired	tired	tiring
titter	tittered	tittered	tittering
toast	toasted	toasted	toasting
toboggan	tobogganed	tobogganed	tobogganing
toddle	toddled	toddled	toddling
toil	toiled	toiled	toiling
tolerate	tolerated	tolerated	tolerating
toll	tolled	tolled	tolling
toot	tooted	tooted	tooting
torment	tormented	tormented	tormenting
torrefy	torrefied	torrefied	torrefying
torture	tortured	tortured	torturing
toss	tossed	tossed	tossing
total	totalled	totalled	totalling
totter	tottered	tottered	tottering
touch	touched	touched	touching
toughen	toughened	toughened	toughening
tour	toured	toured	touring
tow	towed	towed	towing
towel	toweled	toweled	toweling
tower	towered	towered	towering
trace	traced	traced	tracing
trade	traded	traded	trading
traduce	traduced	traduced	traducing
traffic	trafficked	trafficked	trafficking
trail	trailed	trailed	trailing
train	trained	trained	training
trammel	trammeled	trammeled	trammeling
tramp	tramped	tramped	tramping
transact	transacted	transacted	transacting
transcend	transcended	transcended	transcending
transfer	transferred	transferred	transferring
transform	transformed	transformed	transforming
transgress	transgressed	transgressed	transgressing
translate	translated	translated	translating
transmit	transmitted	transmitted	transmitting
transmute	transmuted	transmuted	transmuting
transplant	transplanted	transplanted	transplanting
transport	transported	transported	transporting
trap	trapped	trapped	trapping
travel	travelled	travelled	travelling
trawl	trawled	trawled	trawling
tread	trod	trodden	treading
treasure	treasured	treasured	treasuring
treat	treated	treated	treating
trek	trekked	trekked	trekking
tremble	trembled	trembled	trembling
trend	trended	trended	trending
trespass	trespassed	trespassed	trespassing
trick	tricked	tricked	tricking
trickle	trickled	trickled	trickling
trifurcate	trifurcated	trifurcated	trifurcating
trigger	triggered	triggered	triggering
trill	trilled	trilled	trilling
trim	trimmed	trimmed	trimming
trip	tripped	tripped	tripping
trisect	trisected	trisected	trisecting
triumph	triumphed	triumphed	triumphing
troll	trolled	trolled	trolling
trot	trotted	trotted	trotting
trouble	troubled	troubled	troubling
trounce	trounced	trounced	trouncing
trow	trowed	trowed	trowing
truck	trucked	trucked	trucking
truckle	truckled	truckled	truckling
trump	trumped	trumped	trumping
trundle	trundled	trundled	trundling
trust	trusted	trusted	trusting
try	tried	tried	trying
tuck	tucked	tucked	tucking
tug	tugged	tugged	tugging
tumble	tumbled	tumbled	tumbling
tune	tuned	tuned	tuning
turn	turned	turned	turning
tutor	tutored	tutored	tutoring
tweak	tweaked	tweaked	tweaking
tweet	tweeted	tweeted	tweeting
twinkle	twinkled	twinkled	twinkling
twirl	twirled	twirled	twirling
twist	twisted	twisted	twisting
twitch	twitched	twitched	twitching
twitter	twittered	twittered	twittering
type	typed	typed	typing
typewrite	typewrote	typewritten	typewriting
uglify	uglified	uglified	uglifying
ululate	ululated	ululated	ululating
unarm	unarmed	unarmed	unarming
unbend	unbended	unbended	unbending
unbraid	unbraided	unbraided	unbraiding
uncoil	uncoiled	uncoiled	uncoiling
uncoil	uncoiled	uncoiled	uncoiling
uncover	uncovered	uncovered	uncovering
undergo	underwent	undergone	undergoing
underline	underlined	underlined	underlining
underrate	underrated	underrated	underrating
undersell	undersold	undersold	underselling
undershoot	undershot	undershot	undershooting
understand	understood	understood	understanding
understate	understated	understated	understating
undertake	undertook	undertaken	undertaking
underwrite	underwrote	underwritten	underwriting
undo	undid	undone	undoing
undress	undressed	undressed	undressing
unearth	unearthed	unearthed	unearthing
unfasten	unfastened	unfastened	unfastening
unfold	unfolded	unfolded	unfolding
unfurl	unfurled	unfurled	unfurling
unify	unified	unified	unifying
unite	united	united	uniting
unlearn	unlearned	unlearned	unlearning
unleash	unleashed	unleashed	unleashing
unload	unloaded	unloaded	unloading
unlock	unlocked	unlocked	unlocking
unravel	unraveled	unraveled	unraveling
unruffle	unruffled	unruffled	unruffling
unruffle	unruffled	unruffled	unruffling
unsay	unsaid	unsaid	unsaying
unscrew	unscrewed	unscrewed	unscrewing
unseat	unseated	unseated	unseating
unspeak	unspoke	unspoken	unspeaking
untie	untied	untied	untying
unwind	unwound	unwound	unwinding
unyoke	unyoked	unyoked	unyoking
upgrade	upgraded	upgraded	upgrading
uphold	upheld	upheld	upholding
uplift	uplifted	uplifted	uplifting
upraise	upraised	upraised	upraising
upset	upset	upset	upsetting
urge	urged	urged	urging
use	used	used	using
usher	ushered	ushered	ushering
usurp	usurped	usurped	usurping
utilise	utilised	utilised	utilising
utter	uttered	uttered	uttering
vacate	vacated	vacated	vacating
vaccinate	vaccinateed	vaccinateed	vaccinateing
vacillate	vacillated	vacillated	vacillating
vail	vailed	vailed	vailing
validate	validated	validated	validating
value	valued	valued	valuing
vamp	vamped	vamped	vamping
vanish	vanished	vanished	vanishing
vanquish	vanquished	vanquished	vanquishing
vary	varied	varied	varying
vault	vaulted	vaulted	vaulting
vaunt	vaunted	vaunted	vaunting
veil	veiled	veiled	veiling
vend	vended	vended	vending
veneer	veneered	veneered	veneering
venerate	venerated	venerated	venerating
vent	vented	vented	venting
venture	ventured	ventured	venturing
verify	verified	verified	verifying
veto	vetoed	vetoed	vetoing
vex	vexed	vexed	vexing
victimize	victimized	victimized	victimizing
victual	victualed	victualed	victualing
vie	vied	vied	vying
view	viewed	viewed	viewing
vilify	vilified	vilified	vilifying
vindicate	vindicated	vindicated	vindicating
violate	violated	violated	violating
visit	visited	visited	visiting
vitiate	vitiated	vitiated	vitiating
vivify	vivified	vivified	vivifying
void	voided	voided	voiding
vomit	vomited	vomited	vomiting
vote	voted	voted	voting
vouch	vouched	vouched	vouching
vouchsafe	vouchsafed	vouchsafed	vouchsafing
vow	vowed	vowed	vowing
waddle	waddled	waddled	waddling
wade	waded	waded	wading
waft	wafted	wafted	wafting
wag	wagged	wagged	wagging
wage	waged	waged	waging
wager	wagered	wagered	wagering
waggle	waggled	waggled	waggling
wail	wailed	wailed	wailing
wait	waited	waited	waiting
waive	waived	waived	waiving
wake	woke / waked	woken / waked	waking
walk	walked	walked	walking
wallop	walloped	walloped	walloping
wander	wandered	wandered	wandering
wane	waned	waned	waning
want	wanted	wanted	wanting
war	warred	warred	warring
warble	warbled	warbled	warbling
ward	warded	warded	warding
warm	warmed	warmed	warming
warn	warned	warned	warning
warp	warped	warped	warping
wash	washed	washed	washing
waste	wasted	wasted	wasting
watch	watched	watched	watching
water	watered	watered	watering
wave	waved	waved	waving
waver	wavered	wavered	wavering
wax	waxed	waxed	waxing
waylay	waylaid	waylaid	waylaying
weaken	weakened	weakened	weakening
wean	weaned	weaned	weaning
weapon	weaponed	weaponed	weaponing
wear	wore	worn	wearing
weave	wove	woven	weaving
wed	wedded / wed	wedded / wed	wedding
weed	weeded	weeded	weeding
weep	wept	wept	weeping
weigh	weighed	weighed	weighing
weight	weighted	weighted	weighting
welcome	welcomed	welcomed	welcoming
weld	welded	welded	welding
well	welled	welled	welling
welter	weltered	weltered	weltering
wend	wended	wended	wending
wet	wetted / wet	wetted / wet	wetting
whack	whacked	whacked	whacking
wheedle	wheedled	wheedled	wheedling
wheel	wheeled	wheeled	wheeling
wheeze	wheezeed	wheezeed	wheezeing
whelm	whelmed	whelmed	whelming
whet	whetted	whetted	whetting
whiff	whiffed	whiffed	whiffing
whiffle	whiffled	whiffled	whiffling
whimper	whimpered	whimpered	whimpering
whine	whined	whined	whining
whip	whipped / whipt	whipped / whipt	whipping
whirl	whirled	whirled	whirling
whisper	whispered	whispered	whispering
whistle	whistled	whistled	whistling
whiten	whitened	whitened	whitening
whitewash	whitewashed	whitewashed	whitewashing
whittle	whittled	whittled	whittling
whore	whored	whored	whoring
widen	widened	widened	widening
wield	wielded	wielded	wielding
wiggle	wiggled	wiggled	wiggling
will	willed	willed	willing
wilt	wilted	wilted	wilting
win	won	won	winning
wince	winced	winced	wincing
wind	wound	wound	winding
wing	winged	winged	winging
wink	winked	winked	winking
winnow	winnowed	winnowed	winnowing
wipe	wiped	wiped	wiping
wire	wired	wired	wiring
wish	wished	wished	wishing
wistle	wistled	wistled	wistling
withdraw	withdrew	withdrawn	withdrawing
wither	withered	withered	withering
withhold	withheld	withheld	withholding
withstand	withstood	withstood	withstanding
witness	witnessed	witnessed	witnessing
wive	wived	wived	wiving
wobble	wobbled	wobbled	wobbling
wonder	wondered	wondered	wondering
woo	wooed	wooed	wooing
word	worded	worded	wording
work	worked	worked	working
worry	worried	worried	worrying
worsen	worsened	worsened	worsening
worship	worshipped	worshipped	worshipping
wound	wounded	wounded	wounding
wrangle	wrangled	wrangled	wrangling
wrap	wrapped	wrapped	wrapping
wreck	wrecked	wrecked	wrecking
wrench	wrenched	wrenched	wrenching
wrest	wrested	wrested	wresting
wrestle	wrestled	wrestled	wrestling
wriggle	wriggled	wriggled	wriggling
wring	wrung	wrung	wringing
wrinkle	wrinkled	wrinkled	wrinkling
write	wrote	written	writing
writhe	writhed	writhed	writhing
xerox	xeroxed	xeroxed	xeroxing
yap	yapped	yapped	yapping
yawn	yawned	yawned	yawning
yearn	yearned	yearned	yearning
yell	yelled	yelled	yelling
yellow	yellowed	yellowed	yellowing
yelp	yelped	yelped	yelping
yield	yielded	yielded	yielding
zero	zeroed	zeroed	zeroing
zigzag	zigzagged	zigzagged	zigzagging
zip	zipped	zipped	zipping
zoom	zoomed	zoomed	zooming